&schema: SA
PKRAMOVIGIOF|NORMAL|RAMOVIGIOF|VISIBLE|UNIQUE|VALID
PKRAMOREALEMIS|NORMAL|RAMOREALEMIS|VISIBLE|UNIQUE|VALID
PKRAMOFATURA|NORMAL|RAMOFATURA|VISIBLE|UNIQUE|VALID
PKRAMO|NORMAL|RAMO|VISIBLE|UNIQUE|VALID
SYS_IL0000433728C00027$$|LOB|QUEST_SL_TEMP_EXPLAIN1|VISIBLE|UNIQUE|VALID
PKQUESTACEITITEM|NORMAL|QUESTACEITITEM|VISIBLE|UNIQUE|VALID
PKQUADROSGRUPO|NORMAL|QUADROSGRUPO|VISIBLE|UNIQUE|VALID
PKQUADROSCOBERTURA|NORMAL|QUADROSCOBERTURA|VISIBLE|UNIQUE|VALID
PKQUADROSAGRUPAMENTO|NORMAL|QUADROSAGRUPAMENTO|VISIBLE|UNIQUE|VALID
PKTBIOMETRICASAIDAS|NORMAL|TBIOMETRICASAIDAS|VISIBLE|UNIQUE|VALID
PKTBIOMETRICAATIVOS|NORMAL|TBIOMETRICAATIVOS|VISIBLE|UNIQUE|VALID
IXTBIA01|NORMAL|TBIOMETRICAATIVOS|VISIBLE|NONUNIQUE|VALID
PKTAXAVERBAREFER|NORMAL|TAXAVERBAREFER|VISIBLE|UNIQUE|VALID
PKTAXACOMERCIAL|NORMAL|TAXACOMERCIAL|VISIBLE|UNIQUE|VALID
PKTARIFPRODPERIOD|NORMAL|TARIFPRODPERIOD|VISIBLE|UNIQUE|VALID
PKTARIFINDIVIDUAL|NORMAL|TARIFINDIVIDUAL|VISIBLE|UNIQUE|VALID
PKTARIFINDAGRUP|NORMAL|TARIFINDAGRUP|VISIBLE|UNIQUE|VALID
PKTARIFASPCOBITEM|NORMAL|TARIFASPCOBITEM|VISIBLE|UNIQUE|VALID
PKTARIFAGRUASPPRD|NORMAL|TARIFAGRUASPPRD|VISIBLE|UNIQUE|VALID
PKTARIFACAOVERBA|NORMAL|TARIFACAOVERBA|VISIBLE|UNIQUE|VALID
PKTABSIES|NORMAL|TABSIES|VISIBLE|UNIQUE|VALID
PKTABELPRAZOLONGO|NORMAL|TABELPRAZOLONGO|VISIBLE|UNIQUE|VALID
PKTABELPRAZOCURTO|NORMAL|TABELPRAZOCURTO|VISIBLE|UNIQUE|VALID
PKTABELAFONTE|NORMAL|TABELAFONTE|VISIBLE|UNIQUE|VALID
PK_TEMP_IOF_VG_VI|NORMAL|TEMP_IOF_VG_VI|VISIBLE|UNIQUE|VALID
PKFUPATU|NORMAL|TEMP_FOLLOWUP_ATUALIZADOS|VISIBLE|UNIQUE|VALID
PKCLAUSULCOMPPROD|NORMAL|CLAUSULCOMPPROD|VISIBLE|UNIQUE|VALID
PKCLAUSULAATUARIALESC|NORMAL|CLAUSULAATUARIALESC|VISIBLE|UNIQUE|VALID
PKCLAUSULAATUARIAL|NORMAL|CLAUSULAATUARIAL|VISIBLE|UNIQUE|VALID
PKCLAUSULAASSOCIADA|NORMAL|CLAUSULAASSOCIADA|VISIBLE|UNIQUE|VALID
PKCLAUSULA|NORMAL|CLAUSULA|VISIBLE|UNIQUE|VALID
PKCLASSERISCORAMO|NORMAL|CLASSERISCORAMO|VISIBLE|UNIQUE|VALID
PKCLAESCEMIS|NORMAL|CLAESCEMIS|VISIBLE|UNIQUE|VALID
PKCLAESCCOB|NORMAL|CLAESCCOB|VISIBLE|UNIQUE|VALID
PKCLAESCAGRUPEMIS|NORMAL|CLAESCAGRUPEMIS|VISIBLE|UNIQUE|VALID
PKCIDADES|NORMAL|CIDADES|VISIBLE|UNIQUE|VALID
IXCID00|NORMAL|CIDADES|VISIBLE|UNIQUE|VALID
PKCHEQUEBANCO|NORMAL|CHEQUEBANCO|VISIBLE|UNIQUE|VALID
PKCESSAORAMO|NORMAL|CESSAORAMO|VISIBLE|UNIQUE|VALID
PKCESSAOOBJRISCONS|NORMAL|CESSAOOBJRISCONS|VISIBLE|UNIQUE|VALID
PKCESSAOOBJRIS|NORMAL|CESSAOOBJRIS|VISIBLE|UNIQUE|VALID
PKCESSAOCOBERTURA|NORMAL|CESSAOCOBERTURA|VISIBLE|UNIQUE|VALID
PKCERTIFICADOPREV|NORMAL|CERTIFICADOPREV|VISIBLE|UNIQUE|VALID
IXCERT03_ON|NORMAL|CERTIFICADO|VISIBLE|NONUNIQUE|VALID
IDX$$_EDB30001|NORMAL|CERTIFICADO|VISIBLE|NONUNIQUE|VALID
IXCERT01|NORMAL|CERTIFICADO|VISIBLE|NONUNIQUE|VALID
IXCERT02|NORMAL|CERTIFICADO|VISIBLE|NONUNIQUE|VALID
IXCERT05|NORMAL|CERTIFICADO|VISIBLE|NONUNIQUE|VALID
PKCERTIFICADO|NORMAL|CERTIFICADO|VISIBLE|UNIQUE|VALID
PKCERTIFEMISSAO|NORMAL|CERTIFEMISSAO|VISIBLE|UNIQUE|VALID
PKCERTIFAVISOSIN|NORMAL|CERTIFAVISOSIN|VISIBLE|UNIQUE|VALID
PKCERTIFALTSIES|NORMAL|CERTIFALTSIES|VISIBLE|UNIQUE|VALID
PKCERTIFAGRICOLA|NORMAL|CERTIFAGRICOLA|VISIBLE|UNIQUE|VALID
PKCENTROCUSTO|NORMAL|CENTROCUSTO|VISIBLE|UNIQUE|VALID
PKCAUSASINISTRORAMO|NORMAL|CAUSASINISTRORAMO|VISIBLE|UNIQUE|VALID
PKCAUSASINISTRO|NORMAL|CAUSASINISTRO|VISIBLE|UNIQUE|VALID
PKCATEGORIATARIFARIA|NORMAL|CATEGORIATARIFARIA|VISIBLE|UNIQUE|VALID
PKCARTEIRAFAIXAETARIA|NORMAL|CARTEIRAFAIXAETARIA|VISIBLE|UNIQUE|VALID
IXCARTDAD01|NORMAL|CARTEIRADADOS|VISIBLE|NONUNIQUE|VALID
IXCARTDAD02|NORMAL|CARTEIRADADOS|VISIBLE|NONUNIQUE|VALID
IXCARTDAD03|NORMAL|CARTEIRADADOS|VISIBLE|NONUNIQUE|VALID
IXCARTDAD04|NORMAL|CARTEIRADADOS|VISIBLE|NONUNIQUE|VALID
IXCARTDAD05|NORMAL|CARTEIRADADOS|VISIBLE|NONUNIQUE|VALID
IXCARTDAD07|NORMAL|CARTEIRADADOS|VISIBLE|NONUNIQUE|VALID
IXCARTDAD06|NORMAL|CARTEIRADADOS|VISIBLE|NONUNIQUE|VALID
PKCARTEIRADADOS|NORMAL|CARTEIRADADOS|VISIBLE|UNIQUE|VALID
PKCARTEIRACOBERTURAS|NORMAL|CARTEIRACOBERTURAS|VISIBLE|UNIQUE|VALID
PKCRTA|NORMAL|CARTA_ALTERACAO|VISIBLE|UNIQUE|VALID
PKCARTARECUSAVI|NORMAL|CARTARECUSAVI|VISIBLE|UNIQUE|VALID
IXCRVI01|NORMAL|CARTARECUSAVI|VISIBLE|NONUNIQUE|VALID
PKCARTARECUSAVG|NORMAL|CARTARECUSAVG|VISIBLE|UNIQUE|VALID
PKCARTACOBVG|NORMAL|CARTACOBRANCAVG|VISIBLE|UNIQUE|VALID
PKCARREGPREV|NORMAL|CARREGPREV|VISIBLE|UNIQUE|VALID
PKCARACTVERBACOMP|NORMAL|CARACTVERBACOMP|VISIBLE|UNIQUE|VALID
PKCARACTOBJVERBA|NORMAL|CARACTOBJVERBA|VISIBLE|UNIQUE|VALID
PKCARACTOBJPRODUT|NORMAL|CARACTOBJPRODUT|VISIBLE|UNIQUE|VALID
PKCARACTOBJPRODPREV|NORMAL|CARACTOBJPRODPREV|VISIBLE|UNIQUE|VALID
PKCARACTOBJCOMPOS|NORMAL|CARACTOBJCOMPOS|VISIBLE|UNIQUE|VALID
PKCARACTNATURITEM|NORMAL|CARACTNATURITEM|VISIBLE|UNIQUE|VALID
SYS_IL0000023479C00020$$|LOB|CARACTNATURITEM|VISIBLE|UNIQUE|VALID
PKCARACTFORMAPGTO|NORMAL|CARACTFORMAPGTO|VISIBLE|UNIQUE|VALID
PKCANALVENDAPRODUTO|NORMAL|CANALVENDAPRODUTO|VISIBLE|UNIQUE|VALID
PKCANALVENDA|NORMAL|CANALVENDA|VISIBLE|UNIQUE|VALID
PKCAMPANHAITEMOPCAO|NORMAL|CAMPANHAITEMOPCAO|VISIBLE|UNIQUE|VALID
PKCAMPANHAITEM|NORMAL|CAMPANHAITEM|VISIBLE|UNIQUE|VALID
PKCAMPANHA|NORMAL|CAMPANHA|VISIBLE|UNIQUE|VALID
PKBONUS|NORMAL|BONUS|VISIBLE|UNIQUE|VALID
PKBOMRISCORESPEMIS|NORMAL|BOMRISCORESPEMIS|VISIBLE|UNIQUE|VALID
PKBOMRISCORESP|NORMAL|BOMRISCORESP|VISIBLE|UNIQUE|VALID
PKBOMRISCOQDREST|NORMAL|BOMRISCOQDREST|VISIBLE|UNIQUE|VALID
PKBOMRISCOPONT|NORMAL|BOMRISCOPONT|VISIBLE|UNIQUE|VALID
PKBOMRISCOPERGEMIS|NORMAL|BOMRISCOPERGEMIS|VISIBLE|UNIQUE|VALID
PKBOMRISCOPERG|NORMAL|BOMRISCOPERG|VISIBLE|UNIQUE|VALID
PKBOMRISCOCOEF|NORMAL|BOMRISCOCOEF|VISIBLE|UNIQUE|VALID
PKBIOMETRICA|NORMAL|BIOMETRICA|VISIBLE|UNIQUE|VALID
PKVIGCARACTPRODPREV|NORMAL|VIGCARACTPRODPREV|VISIBLE|UNIQUE|VALID
PKVIAGEMNACIONAL|NORMAL|VIAGEMNACIONAL|VISIBLE|UNIQUE|VALID
PKVGTXESCALACOBTERC|NORMAL|VGTXESCALACOBTERC|VISIBLE|UNIQUE|VALID
PKVGTXESCALACOBERTURA|NORMAL|VGTXESCALACOBERTURA|VISIBLE|UNIQUE|VALID
PKVGSEGURADOVIDA|NORMAL|VGSEGURADOVIDA|VISIBLE|UNIQUE|VALID
IXVGSVG08|NORMAL|VGSEGURADOVIDA|VISIBLE|NONUNIQUE|VALID
IXVGSVG02|NORMAL|VGSEGURADOVIDA|VISIBLE|NONUNIQUE|VALID
IXVGSVG06|NORMAL|VGSEGURADOVIDA|VISIBLE|NONUNIQUE|VALID
IXVGSVG01|NORMAL|VGSEGURADOVIDA|VISIBLE|NONUNIQUE|VALID
IXVGSVG00|NORMAL|VGSEGURADOVIDA|VISIBLE|NONUNIQUE|VALID
IXVGSVG03|NORMAL|VGSEGURADOVIDA|VISIBLE|NONUNIQUE|VALID
IXVGSVG04|NORMAL|VGSEGURADOVIDA|VISIBLE|NONUNIQUE|VALID
IXVGSVG07|FUNCTION-BASED NORMAL|VGSEGURADOVIDA|VISIBLE|NONUNIQUE|VALID
PKVGPLANOREMUNITEM|NORMAL|VGPLANOREMUNITEM|VISIBLE|UNIQUE|VALID
PKVGPLANOREMUNEMI|NORMAL|VGPLANOREMUNEMI|VISIBLE|UNIQUE|VALID
PKVGPLANOREMUNAGRUP|NORMAL|VGPLANOREMUNAGRUP|VISIBLE|UNIQUE|VALID
PKVGPLANOREMUN|NORMAL|VGPLANOREMUN|VISIBLE|UNIQUE|VALID
PKVGPLANOINDGRUPO|NORMAL|VGPLANOINDGRUPO|VISIBLE|UNIQUE|VALID
PKVGPARTREMUNITEM|NORMAL|VGPARTREMUNITEM|VISIBLE|UNIQUE|VALID
PKVGPARTREMUNEMI|NORMAL|VGPARTREMUNEMI|VISIBLE|UNIQUE|VALID
VGPRE00|NORMAL|VGPARTREMUNEMI|VISIBLE|NONUNIQUE|VALID
PKVGPARTREMUNAGRUP|NORMAL|VGPARTREMUNAGRUP|VISIBLE|UNIQUE|VALID
PKVGPARTREMUN|NORMAL|VGPARTREMUN|VISIBLE|UNIQUE|VALID
IXVGMOVSEGSIMP00|NORMAL|VGMOVSEGSIMPLIFICADO|VISIBLE|NONUNIQUE|VALID
PKVGMOVSEGSIMPLIFICADO|NORMAL|VGMOVSEGSIMPLIFICADO|VISIBLE|UNIQUE|VALID
IXVGMIP01|NORMAL|VGMOVITEMPESSOA|VISIBLE|NONUNIQUE|VALID
PKVGMOVITEMPESSOA|NORMAL|VGMOVITEMPESSOA|VISIBLE|UNIQUE|VALID
PKVGFATURACOMPL|NORMAL|VGFATURACOMPL|VISIBLE|UNIQUE|VALID
PKVGCOBERTPLANOINDTERC|NORMAL|VGCOBERTPLANOINDTERC|VISIBLE|UNIQUE|VALID
PKVGCOBERTPLANOINDIV|NORMAL|VGCOBERTPLANOINDIV|VISIBLE|UNIQUE|VALID
PKVGCARNEPAGTO|NORMAL|VGCARNEPAGTO|VISIBLE|UNIQUE|VALID
PKVERBASINISTRO|NORMAL|VERBASINISTRO|VISIBLE|UNIQUE|VALID
PKVERBACOMPOSREFER|NORMAL|VERBACOMPOSREFER|VISIBLE|UNIQUE|VALID
PKVERBACOMPOSPROD|NORMAL|VERBACOMPOSPROD|VISIBLE|UNIQUE|VALID
PKVERBA|NORMAL|VERBA|VISIBLE|UNIQUE|VALID
PKVARIAVELZ|NORMAL|VARIAVELZ|VISIBLE|UNIQUE|VALID
PKVARIAVELY|NORMAL|VARIAVELY|VISIBLE|UNIQUE|VALID
PKVARIAVELX|NORMAL|VARIAVELX|VISIBLE|UNIQUE|VALID
STATISTIC_CDFONTE|NORMAL|VALORMERCADO|VISIBLE|NONUNIQUE|VALID
PKVALORMERCADO|NORMAL|VALORMERCADO|VISIBLE|UNIQUE|VALID
PKUTILVARIAVELX|NORMAL|UTILVARIAVELX|VISIBLE|UNIQUE|VALID
PKUTILFATORCOBERTURA|NORMAL|UTILFATORCOBERTURA|VISIBLE|UNIQUE|VALID
PKUTILAUTO|NORMAL|UTILAUTO|VISIBLE|UNIQUE|VALID
PKUSUARIOMODULO|NORMAL|USUARIOMODULO|VISIBLE|UNIQUE|VALID
PKUSUARIOEVENTO|NORMAL|USUARIOEVENTO|VISIBLE|UNIQUE|VALID
PKUSUARIOAPROVSINISTRO|NORMAL|USUARIOAPROVSINISTRO|VISIBLE|UNIQUE|VALID
PKUSUARIO|NORMAL|USUARIO|VISIBLE|UNIQUE|VALID
PKUNIDADEPRODVINC|NORMAL|UNIDADEPRODVINC|VISIBLE|UNIQUE|VALID
PKUNIDADENEGOCIO|NORMAL|UNIDADENEGOCIO|VISIBLE|UNIQUE|VALID
PKTXESCALACOBTERC|NORMAL|TXESCALACOBTERC|VISIBLE|UNIQUE|VALID
PKTXESCALACOBERTURA|NORMAL|TXESCALACOBERTURA|VISIBLE|UNIQUE|VALID
IXTXESCCOBERT01|NORMAL|TXESCALACOBERTURA|VISIBLE|NONUNIQUE|VALID
IXTXESCCOBERT00|NORMAL|TXESCALACOBERTURA|VISIBLE|NONUNIQUE|VALID
PK_TROCAARQUIVOSRESULT|NORMAL|TROCAARQUIVOSRESULT|VISIBLE|UNIQUE|VALID
IDX$$_46AEB0001|NORMAL|TROCAARQUIVOSRESULT|VISIBLE|NONUNIQUE|VALID
IXTROCAARQLOTE00|NORMAL|TROCAARQUIVOSLOTES|VISIBLE|NONUNIQUE|VALID
PK_TROCAARQUIVOSLOTES|NORMAL|TROCAARQUIVOSLOTES|VISIBLE|UNIQUE|VALID
IXTROCAARQLOTE01|BITMAP|TROCAARQUIVOSLOTES|VISIBLE|NONUNIQUE|VALID
PK_TROCAARQUIVOSLOGHIST|NORMAL|TROCAARQUIVOSLOG_HIST|VISIBLE|UNIQUE|VALID
PK_TROCAARQUIVOSLOG|NORMAL|TROCAARQUIVOSLOG|VISIBLE|UNIQUE|VALID
PK_TROCAARQUIVOSDADOS|NORMAL|TROCAARQUIVOSDADOS|VISIBLE|UNIQUE|VALID
PKTROCAARQUIVOS|NORMAL|TROCAARQUIVOS|VISIBLE|UNIQUE|VALID
IXTRC00|NORMAL|TROCAARQUIVOS|VISIBLE|NONUNIQUE|VALID
PKTRANSPORTEAUXILIAR|NORMAL|TRANSPORTEAUXILIAR|VISIBLE|UNIQUE|VALID
PKTPDOCSINISTRORAMO|NORMAL|TPDOCSINISTRORAMO|VISIBLE|UNIQUE|VALID
PKTPCOBRESERVAPREV|NORMAL|TPCOBRESERVAPREV|VISIBLE|UNIQUE|VALID
PKTOTEMISRAMO|NORMAL|TOTEMISRAMO|VISIBLE|UNIQUE|VALID
PKTOTALEMISSAO|NORMAL|TOTALEMISSAO|VISIBLE|UNIQUE|VALID
PKTOTALCOGNOS|NORMAL|TOTALCOGNOS|VISIBLE|UNIQUE|VALID
IXTOTALCOGNOS01|NORMAL|TOTALCOGNOS|VISIBLE|NONUNIQUE|VALID
PKTOMADOR|NORMAL|TOMADOR|VISIBLE|UNIQUE|VALID
IXTOM00|NORMAL|TOMADOR|VISIBLE|UNIQUE|VALID
IXTMPSIBCTCOB01|NORMAL|TMP_SIBANF_CTRL_COBR|VISIBLE|NONUNIQUE|VALID
IXTMPBATCH00|NORMAL|TMP_BATCH|VISIBLE|NONUNIQUE|VALID
PK_MIG_VI_LOTE|NORMAL|MIGRA_VI_LOTE|VISIBLE|UNIQUE|VALID
PK_MIG_VI_DADOS|NORMAL|MIGRA_VI_DADOS|VISIBLE|UNIQUE|VALID
PK_MIG_VI_CRITICAS|NORMAL|MIGRA_VI_CRITICAS|VISIBLE|UNIQUE|VALID
PK_MIG_VI_CRITICADOS|NORMAL|MIGRA_VI_CRITICADOS|VISIBLE|UNIQUE|VALID
PKMIGRAVICONNECTGRP|NORMAL|MIGRA_VI_CONNECT_GRP|VISIBLE|UNIQUE|VALID
IXMIGVICONGRP00|NORMAL|MIGRA_VI_CONNECT_GRP|VISIBLE|NONUNIQUE|VALID
PKMIGRA_VI_CONNECT_EQP|NORMAL|MIGRA_VI_CONNECT_EQP|VISIBLE|UNIQUE|VALID
IXMIGVICONEQP00|NORMAL|MIGRA_VI_CONNECT_EQP|VISIBLE|NONUNIQUE|VALID
IXMIGVICONEND00|NORMAL|MIGRA_VI_CONNECT_END|VISIBLE|NONUNIQUE|VALID
PKMIGVICONCOB|NORMAL|MIGRA_VI_CONNECT_END|VISIBLE|UNIQUE|VALID
PKMIGRAVICONCOB|NORMAL|MIGRA_VI_CONNECT_COB|VISIBLE|UNIQUE|VALID
IDX$$_248300001|FUNCTION-BASED NORMAL|MIGRA_VI_CONNECT_COB|VISIBLE|NONUNIQUE|VAL
IXMIGVICONCOB00|NORMAL|MIGRA_VI_CONNECT_COB|VISIBLE|NONUNIQUE|VALID
PKMIGRA_VI_CONNECT_BENEF|NORMAL|MIGRA_VI_CONNECT_BENEF|VISIBLE|UNIQUE|VALID
IXMIGVICONBEN00|NORMAL|MIGRA_VI_CONNECT_BENEF|VISIBLE|NONUNIQUE|VALID
PK_MPV|NORMAL|MIGRA_PLANO_VIDA|VISIBLE|UNIQUE|VALID
PKMIGRADPSARESPOSTAS|NORMAL|MIGRA_DPS_RESPOSTAS|VISIBLE|UNIQUE|VALID
PKMIGRAPERGUNTASPRODUTO|NORMAL|MIGRA_DPS_PERGUNTAS_PRODUTO|VISIBLE|UNIQUE|VALID
PKMIGRADPSAPERGUNTAS|NORMAL|MIGRA_DPS_PERGUNTAS|VISIBLE|UNIQUE|VALID
PKMIGRADPSADECLARACAO|NORMAL|MIGRA_DPS_DECLARACAO|VISIBLE|UNIQUE|VALID
PKMIGRACAO|NORMAL|MIGRACAO|VISIBLE|UNIQUE|VALID
PKMERCADORIA|NORMAL|MERCADORIA|VISIBLE|UNIQUE|VALID
PKMENSAGEMSISTEMA|NORMAL|MENSAGEMSISTEMA|VISIBLE|UNIQUE|VALID
IXMTC01|NORMAL|MATCHCODE|VISIBLE|NONUNIQUE|VALID
PKMATCHCODE|NORMAL|MATCHCODE|VISIBLE|UNIQUE|VALID
IXMAPFRCAP00|NORMAL|MAPFRECAP|VISIBLE|NONUNIQUE|VALID
IDX$$_64BD0001|NORMAL|MAPFRECAP|VISIBLE|NONUNIQUE|VALID
PKMAPFRECAP|NORMAL|MAPFRECAP|VISIBLE|UNIQUE|VALID
PKMAPAPRODUCAOPROD|NORMAL|MAPAPRODUCAOPROD|VISIBLE|UNIQUE|VALID
PKMAPAPRODUCAO|NORMAL|MAPAPRODUCAO|VISIBLE|UNIQUE|VALID
IXLOGMOVRESS00|NORMAL|LOG_MOVIMENTO_RESSEGURO|VISIBLE|NONUNIQUE|VALID
PKLOGALTSUSEPFATURA|NORMAL|LOG_ALTERACAO_SUSEP_FATURA|VISIBLE|UNIQUE|VALID
IXLAD03|NORMAL|LOG_ALTERACAO_DETA|VISIBLE|NONUNIQUE|VALID
IXLAD02|NORMAL|LOG_ALTERACAO_DETA|VISIBLE|NONUNIQUE|VALID
IXLAD01|NORMAL|LOG_ALTERACAO_DETA|VISIBLE|NONUNIQUE|VALID
PKLOGALTERACAODETA|NORMAL|LOG_ALTERACAO_DETA|VISIBLE|UNIQUE|VALID
IXLOGALTCOR02|NORMAL|LOG_ALTERACAO_CORRETOR|VISIBLE|NONUNIQUE|VALID
IXLOGALTCOR01|NORMAL|LOG_ALTERACAO_CORRETOR|VISIBLE|NONUNIQUE|VALID
PKLOGALTERACAOCAT|NORMAL|LOG_ALTERACAO_CAT|VISIBLE|UNIQUE|VALID
PKLOGSIESBKP|NORMAL|LOGSIESBKP|VISIBLE|UNIQUE|VALID
IXLOGS01|NORMAL|LOGSIES|VISIBLE|NONUNIQUE|VALID
PKLOGSIES|NORMAL|LOGSIES|VISIBLE|UNIQUE|VALID
IXLOGS02|NORMAL|LOGSIES|VISIBLE|NONUNIQUE|VALID
PKLOGINRCP|NORMAL|LOGINRCP|VISIBLE|UNIQUE|VALID
IXLOGVI01|NORMAL|LOGIMPVI|VISIBLE|NONUNIQUE|VALID
PKLOGIMPVI|NORMAL|LOGIMPVI|VISIBLE|UNIQUE|VALID
PKLOGEMISSUSUARIO|NORMAL|LOGEMISSUSUARIO|VISIBLE|UNIQUE|VALID
PKLOGEMISSAO|NORMAL|LOGEMISSAO|VISIBLE|UNIQUE|VALID
PKLOGCARTACBR|NORMAL|LOGCARTACOBRANCA|VISIBLE|UNIQUE|VALID
PKLOGCANCVI|NORMAL|LOGCANCVI|VISIBLE|UNIQUE|VALID
IXLCV01|NORMAL|LOGCANCVI|VISIBLE|NONUNIQUE|VALID
IXLOGBATCH00|FUNCTION-BASED NORMAL|LOGBATCH|VISIBLE|NONUNIQUE|VALID
IDX$$_01170001|NORMAL|LOGBATCH|VISIBLE|NONUNIQUE|VALID
PKLOCALRISCO|NORMAL|LOCALRISCO|VISIBLE|UNIQUE|VALID
PKLIVRORO|NORMAL|LIVRORO|VISIBLE|UNIQUE|VALID
PKLIVRORAZAO|NORMAL|LIVRORAZAO|VISIBLE|UNIQUE|VALID
IXLD07|FUNCTION-BASED NORMAL|LIVRODIARIO|VISIBLE|NONUNIQUE|VALID
IXLD06|NORMAL|LIVRODIARIO|VISIBLE|NONUNIQUE|VALID
PKLIVRODIARIO|NORMAL|LIVRODIARIO|VISIBLE|UNIQUE|VALID
IXLD01|NORMAL|LIVRODIARIO|VISIBLE|NONUNIQUE|VALID
IXLD05|NORMAL|LIVRODIARIO|VISIBLE|NONUNIQUE|VALID
IXLD03|NORMAL|LIVRODIARIO|VISIBLE|NONUNIQUE|VALID
IXLD02|NORMAL|LIVRODIARIO|VISIBLE|NONUNIQUE|VALID
IXLD04|NORMAL|LIVRODIARIO|VISIBLE|NONUNIQUE|VALID
IXLD08|FUNCTION-BASED NORMAL|LIVRODIARIO|VISIBLE|NONUNIQUE|VALID
PKLINHATXTPLANOAGRTXT|NORMAL|LINHATXTPLANOAGRTXT|VISIBLE|UNIQUE|VALID
PKLINHATXTPALNOARG|NORMAL|LINHATXTPLANOAGR|VISIBLE|UNIQUE|VALID
PKLINHATXTEMISSAOTXT|NORMAL|LINHATXTEMISSAOTXT|VISIBLE|UNIQUE|VALID
SYS_IL0000029077C00005$$|LOB|LINHATXTEMISSAO|VISIBLE|UNIQUE|VALID
PKLINHATXTEMISSAO|NORMAL|LINHATXTEMISSAO|VISIBLE|UNIQUE|VALID
PKLIMPARTABELAS|NORMAL|LIMPARTABELAS|VISIBLE|UNIQUE|VALID
PKLIMITECARTAOPROPOSTA|NORMAL|LIMITE_CARTAO_PROPOSTA|VISIBLE|UNIQUE|VALID
PKLIMITEISATIVIDADE|NORMAL|LIMITEISATIVIDADE|VISIBLE|UNIQUE|VALID
PKLIMITEINFUSUAR|NORMAL|LIMITEINFUSUAR|VISIBLE|UNIQUE|VALID
PKLIMITEINFRAMOUSR|NORMAL|LIMITEINFRAMOUSR|VISIBLE|UNIQUE|VALID
PKLIMITEINFPRDUSR|NORMAL|LIMITEINFPRDUSR|VISIBLE|UNIQUE|VALID
PKLIMITEINFPRDALC|NORMAL|LIMITEINFPRDALC|VISIBLE|UNIQUE|VALID
PKLIMITEINFALCADA|NORMAL|LIMITEINFALCADA|VISIBLE|UNIQUE|VALID
PKLIMITEERCOBERTURA|NORMAL|LIMITEERCOBERTURA|VISIBLE|UNIQUE|VALID
PKLIMITEBAIXARESSEG|NORMAL|LIMITEBAIXARESSEG|VISIBLE|UNIQUE|VALID
PKLIMITEAPROVAINF|NORMAL|LIMITEAPROVAINF|VISIBLE|UNIQUE|VALID
PKLIMINFRAMOALC|NORMAL|LIMINFRAMOALC|VISIBLE|UNIQUE|VALID
PKLICENCA|NORMAL|LICENCA|VISIBLE|UNIQUE|VALID
IXLEVCNPJCPF00|NORMAL|LEVANTAMENTOCNPJCPF|VISIBLE|NONUNIQUE|VALID
PKLEVANTAMENTOATUARIAL|NORMAL|LEVANTAMENTOATUARIAL|VISIBLE|UNIQUE|VALID
IXLEVATU00|NORMAL|LEVANTAMENTOATUARIAL|VISIBLE|NONUNIQUE|VALID
ACESSO_SUB_EMPRESA_WEB_PK|NORMAL|ACESSO_SUB_EMPRESA_WEB|VISIBLE|UNIQUE|VALID
ACESSO_EMPRESA_WEB_PK|NORMAL|ACESSO_EMPRESA_WEB|VISIBLE|UNIQUE|VALID
PKACESSORIOS|NORMAL|ACESSORIOS|VISIBLE|UNIQUE|VALID
PKACELERACAOPRODUTO|NORMAL|ACELERACAOPRODUTO|VISIBLE|UNIQUE|VALID
PKACEITPENDENTE|NORMAL|ACEITPENDENTE|VISIBLE|UNIQUE|VALID
PKACEITACAO|NORMAL|ACEITACAO|VISIBLE|UNIQUE|VALID
PKPLATAFORMATERCEIRORAMO|NORMAL|PLATAFORMATERCEIRORAMO|VISIBLE|UNIQUE|VALID
PKPLATAFORMATERCEIROPRODUTO|NORMAL|PLATAFORMATERCEIROPRODUTO|VISIBLE|UNIQUE|VALI
PKPLANOPPCLASSE|NORMAL|PLANOPPCLASSE|VISIBLE|UNIQUE|VALID
PKPLANOPP|NORMAL|PLANOPP|VISIBLE|UNIQUE|VALID
PKPLANOPAGTOPRODUTOR|NORMAL|PLANOPAGTOPRODUTOR|VISIBLE|UNIQUE|VALID
IDX$$_04770008|NORMAL|PLANOINDGRUPO|VISIBLE|NONUNIQUE|VALID
PKPLANOINDGRUPO|NORMAL|PLANOINDGRUPO|VISIBLE|UNIQUE|VALID
PKPLANOCOMISSAO|NORMAL|PLANOCOMISSAO|VISIBLE|UNIQUE|VALID
PKPLANOCOMCORR|NORMAL|PLANOCOMCORR|VISIBLE|UNIQUE|VALID
PKPLANOCESSAOTIPO|NORMAL|PLANOCESSAOTIPO|VISIBLE|UNIQUE|VALID
PKPLANOCESSAOESC|NORMAL|PLANOCESSAOESC|VISIBLE|UNIQUE|VALID
PKPLANOCESSAO|NORMAL|PLANOCESSAO|VISIBLE|UNIQUE|VALID
PKPLANOATUARIAL|NORMAL|PLANOATUARIAL|VISIBLE|UNIQUE|VALID
PKPARTICSEGURAOBJ|NORMAL|PARTICSEGURAOBJ|VISIBLE|UNIQUE|VALID
PKPARTICISCOBERT|NORMAL|PARTICISCOBERT|VISIBLE|UNIQUE|VALID
PKPARTICIPITEM|NORMAL|PARTICIPITEM|VISIBLE|UNIQUE|VALID
PKPARTICACORDO|NORMAL|PARTICACORDO|VISIBLE|UNIQUE|VALID
PKPARECERTECNICO|NORMAL|PARECERTECNICO|VISIBLE|UNIQUE|VALID
PKPARCRESSEGURORAMO|NORMAL|PARCRESSEGURORAMO|VISIBLE|UNIQUE|VALID
PKPARCPRODORGAOPER|NORMAL|PARCPRODORGAOPER|VISIBLE|UNIQUE|VALID
PKPARCPRODINSPER|NORMAL|PARCPRODINSPER|VISIBLE|UNIQUE|VALID
PKPARCPREMIORAMO|NORMAL|PARCPREMIORAMO|VISIBLE|UNIQUE|VALID
PKPARCPREMIACAORAMO|NORMAL|PARCPREMIACAORAMO|VISIBLE|UNIQUE|VALID
PKPARCPAGTOTERCITEM|NORMAL|PARCPAGTOTERCITEM|VISIBLE|UNIQUE|VALID
PKPARCEXCRESPIRB|NORMAL|PARCEXCRESPIRB|VISIBLE|UNIQUE|VALID
PKPARCELASINISTRO|NORMAL|PARCELASINISTRO|VISIBLE|UNIQUE|VALID
IXPARCELARAMO_NOVA01|NORMAL|PARCELARAMO_NOVA|VISIBLE|NONUNIQUE|VALID
IXPARCELARAMO01|NORMAL|PARCELARAMO|VISIBLE|NONUNIQUE|VALID
IXPP00|NORMAL|PARCELAPREMIO|VISIBLE|NONUNIQUE|VALID
IXPP05|NORMAL|PARCELAPREMIO|VISIBLE|NONUNIQUE|VALID
IXPP11|NORMAL|PARCELAPREMIO|VISIBLE|NONUNIQUE|VALID
IXPP03|NORMAL|PARCELAPREMIO|VISIBLE|NONUNIQUE|VALID
IXPP09|NORMAL|PARCELAPREMIO|VISIBLE|NONUNIQUE|VALID
IXPP08|NORMAL|PARCELAPREMIO|VISIBLE|NONUNIQUE|VALID
IXPP10|NORMAL|PARCELAPREMIO|VISIBLE|NONUNIQUE|VALID
IDX$$_00340003|NORMAL|PARCELAPREMIO|VISIBLE|NONUNIQUE|VALID
IDX$$_00340002|NORMAL|PARCELAPREMIO|VISIBLE|NONUNIQUE|VALID
IXPP01|NORMAL|PARCELAPREMIO|VISIBLE|NONUNIQUE|VALID
IDX$$_17AA20001|NORMAL|PARCELAPREMIO|VISIBLE|NONUNIQUE|VALID
IXPP04|NORMAL|PARCELAPREMIO|VISIBLE|NONUNIQUE|VALID
IXPP02|NORMAL|PARCELAPREMIO|VISIBLE|NONUNIQUE|VALID
IDX$$_44F850002|NORMAL|PARCELAPREMIO|VISIBLE|NONUNIQUE|VALID
PKPARCELAPREMIO|NORMAL|PARCELAPREMIO|VISIBLE|UNIQUE|VALID
IXPP07|NORMAL|PARCELAPREMIO|VISIBLE|NONUNIQUE|VALID
PKPARCELAPAGTOTERCEIRO|NORMAL|PARCELAPAGTOTERCEIRO|VISIBLE|UNIQUE|VALID
IXPARCPAGTER00|NORMAL|PARCELAPAGTOTERCEIRO|VISIBLE|NONUNIQUE|VALID
PKPARCELAEMPRESTIMOCORRETOR|NORMAL|PARCELAEMPRESTIMOCORRETOR|VISIBLE|UNIQUE|VALI
PKPARCELACESSAO|NORMAL|PARCELACESSAO|VISIBLE|UNIQUE|VALID
PKPARCELACERTIFICADO|NORMAL|PARCELACERTIFICADO|VISIBLE|UNIQUE|VALID
SYS_C00383144|NORMAL|PARCEIRO_VG_TIP_VINC|VISIBLE|UNIQUE|VALID
SYS_C00383134|NORMAL|PARCEIRO_VG_SUBESTIP|VISIBLE|UNIQUE|VALID
SYS_C00383067|NORMAL|PARCEIRO_VG_ESTIP|VISIBLE|UNIQUE|VALID
SYS_C00383160|NORMAL|PARCEIRO_VG_COBERT|VISIBLE|UNIQUE|VALID
PKPARCDESPFIN|NORMAL|PARCDESPFIN|VISIBLE|UNIQUE|VALID
PKPARCCTARECFIN|NORMAL|PARCCTARECFIN|VISIBLE|UNIQUE|VALID
PKPARCCONJUG|NORMAL|PARCCONJUG|VISIBLE|UNIQUE|VALID
IXPARCCOMRM01|NORMAL|PARCCOMISSRAMO|VISIBLE|NONUNIQUE|VALID
IXPARCCOMRM00|NORMAL|PARCCOMISSRAMO|VISIBLE|NONUNIQUE|VALID
PKPARCCOMISSRAMO|NORMAL|PARCCOMISSRAMO|VISIBLE|UNIQUE|VALID
IXPARCCOMRM02|NORMAL|PARCCOMISSRAMO|VISIBLE|NONUNIQUE|VALID
PKPARCCESSAORAMO|NORMAL|PARCCESSAORAMO|VISIBLE|UNIQUE|VALID
IXPCR00|NORMAL|PARCCESSAORAMO|VISIBLE|NONUNIQUE|VALID
PKPARCCESSAOCONS|NORMAL|PARCCESSAOCONS|VISIBLE|UNIQUE|VALID
PK_KITEDUCH01|NORMAL|KIT_EDUC_H01_HEADER|VISIBLE|UNIQUE|VALID
PK_KITEDUCH00|NORMAL|KIT_EDUC_H00_HEADER|VISIBLE|UNIQUE|VALID
IXKITEDUCCONTROLE00|NORMAL|KIT_EDUC_CONTROLE|VISIBLE|NONUNIQUE|VALID
PK_KITEDUCC07|NORMAL|KIT_EDUC_C07_PARCELAS|VISIBLE|UNIQUE|VALID
PK_KITEDUCC06|NORMAL|KIT_EDUC_C06_PRODUTO_RAMO|VISIBLE|UNIQUE|VALID
PK_KITEDUCC05|NORMAL|KIT_EDUC_C05_BENEFICIARIOS|VISIBLE|UNIQUE|VALID
PK_KITEDUCC04|NORMAL|KIT_EDUC_C04_COBERTURAS|VISIBLE|UNIQUE|VALID
IDX$$_F6BA0007|NORMAL|KIT_EDUC_C04_COBERTURAS|VISIBLE|NONUNIQUE|VALID
IX_KITEDUCC03_01|NORMAL|KIT_EDUC_C03_CERTIFICADO|VISIBLE|NONUNIQUE|VALID
PK_KITEDUCC03|NORMAL|KIT_EDUC_C03_CERTIFICADO|VISIBLE|UNIQUE|VALID
IX_KITEDUCC02_01|NORMAL|KIT_EDUC_C02_SUBGRUPO|VISIBLE|NONUNIQUE|VALID
PK_KITEDUCC02|NORMAL|KIT_EDUC_C02_SUBGRUPO|VISIBLE|UNIQUE|VALID
IX_KITEDUCC01_01|NORMAL|KIT_EDUC_C01_ESTIPULANTE|VISIBLE|NONUNIQUE|VALID
PK_KITEDUCC01|NORMAL|KIT_EDUC_C01_ESTIPULANTE|VISIBLE|UNIQUE|VALID
IDX$$_F6BA0006|NORMAL|KIT_EDUC_B05_FAT_RESUMO|VISIBLE|NONUNIQUE|VALID
IXKITEDUB05FATRESUMO00|NORMAL|KIT_EDUC_B05_FAT_RESUMO|VISIBLE|NONUNIQUE|VALID
IDX$$_F6BA0005|NORMAL|KIT_EDUC_B04_FAT_ESTIPULANTE|VISIBLE|NONUNIQUE|VALID
IXKITEDUB04FATESTIP00|NORMAL|KIT_EDUC_B04_FAT_ESTIPULANTE|VISIBLE|NONUNIQUE|VALI
IDX$$_F6BA0004|NORMAL|KIT_EDUC_B03_BOLETO|VISIBLE|NONUNIQUE|VALID
IXKITEDUB03BOLETO00|NORMAL|KIT_EDUC_B03_BOLETO|VISIBLE|NONUNIQUE|VALID
IDX$$_F6BA0003|NORMAL|KIT_EDUC_B02_MOVIMENTO_FATURA|VISIBLE|NONUNIQUE|VALID
IXKITEDUB02MOVFAT00|NORMAL|KIT_EDUC_B02_MOVIMENTO_FATURA|VISIBLE|NONUNIQUE|VALID
IDX$$_F6BA0002|NORMAL|KIT_EDUC_B01_FATURA|VISIBLE|NONUNIQUE|VALID
IXKITEDUB01FATURA00|NORMAL|KIT_EDUC_B01_FATURA|VISIBLE|NONUNIQUE|VALID
IXKITEDUA03CARTABV00|NORMAL|KIT_EDUC_A03_CARTA_BOAS_VINDAS|VISIBLE|NONUNIQUE|VAL
IXKITEDUA02ENDCLI00|NORMAL|KIT_EDUC_A02_END_CLIENTE|VISIBLE|NONUNIQUE|VALID
IXKITEDUA02CARTACOB00|NORMAL|KIT_EDUC_A02_CARTA_COBRANCA|VISIBLE|NONUNIQUE|VALID
IDX$$_F6BA0001|NORMAL|KIT_EDUC_A01_END_CORRETOR|VISIBLE|NONUNIQUE|VALID
IXKITEDUA01ENDCORR00|NORMAL|KIT_EDUC_A01_END_CORRETOR|VISIBLE|NONUNIQUE|VALID
IXKITEDUA01CAPAEND00|NORMAL|KIT_EDUC_A01_CAPA_END_VG|VISIBLE|NONUNIQUE|VALID
PKNRCER|NORMAL|KITVICONTROLEIMPCARCER|VISIBLE|UNIQUE|VALID
IXKITVICER02|NORMAL|KITVICER|VISIBLE|NONUNIQUE|VALID
IXKITVICER03|NORMAL|KITVICER|VISIBLE|NONUNIQUE|VALID
IXKITVICER01|NORMAL|KITVICER|VISIBLE|NONUNIQUE|VALID
PKKITCER|NORMAL|KITVICER|VISIBLE|UNIQUE|VALID
KITVICARTERINHA|NORMAL|KITVICARTERINHA|VISIBLE|UNIQUE|VALID
KITVICARTAS|NORMAL|KITVICARTAS|VISIBLE|UNIQUE|VALID
PKKITB0712|NORMAL|KITVIB0712|VISIBLE|UNIQUE|VALID
PKKITB0106|NORMAL|KITVIB0106|VISIBLE|UNIQUE|VALID
IXKITVIBO00|NORMAL|KITVIB0106|VISIBLE|NONUNIQUE|VALID
PKKITIMPRESSAOVISEGVIA|NORMAL|KITIMPRESSAOVISEGVIA|VISIBLE|UNIQUE|VALID
PKKITIMPRESSAOVI|NORMAL|KITIMPRESSAOVI|VISIBLE|UNIQUE|VALID
IXKITIMPRESSAOVI|NORMAL|KITIMPRESSAOVI|VISIBLE|NONUNIQUE|VALID
PKKITIMPRESSAOVGSEGVIA|NORMAL|KITIMPRESSAOVGSEGVIA|VISIBLE|UNIQUE|VALID
IXKITIMPVGMAIL00|NORMAL|KITIMPRESSAOVGEMAILS|VISIBLE|NONUNIQUE|VALID
PKKITIMPRESSAOVG|NORMAL|KITIMPRESSAOVG|VISIBLE|UNIQUE|VALID
IXKITIMPVG02|NORMAL|KITIMPRESSAOVG|VISIBLE|NONUNIQUE|VALID
IXKITIMPVG01|NORMAL|KITIMPRESSAOVG|VISIBLE|NONUNIQUE|VALID
IXKITIMPVG03|NORMAL|KITIMPRESSAOVG|VISIBLE|NONUNIQUE|VALID
PKTIPRESPONSRISCO|NORMAL|TIPRESPONSRISCO|VISIBLE|UNIQUE|VALID
PKTIPORESERVAPREV|NORMAL|TIPORESERVAPREV|VISIBLE|UNIQUE|VALID
PKTIPONATURPROD|NORMAL|TIPONATURPROD|VISIBLE|UNIQUE|VALID
PKTIPONATURITEM|NORMAL|TIPONATURITEM|VISIBLE|UNIQUE|VALID
PKTIPOITEMVALSEG|NORMAL|TIPOITEMVALSEG|VISIBLE|UNIQUE|VALID
PKTIPOFATOR|NORMAL|TIPOFATOR|VISIBLE|UNIQUE|VALID
PKTIPODOCSINISTRO|NORMAL|TIPODOCSINISTRO|VISIBLE|UNIQUE|VALID
PKTIPODOCSINCOBERTURA|NORMAL|TIPODOCSINCOBERTURA|VISIBLE|UNIQUE|VALID
PKTIPODOCCERTIFICADO|NORMAL|TIPODOCCERTIFICADO|VISIBLE|UNIQUE|VALID
PKTIPOCOBERTBIOMETRICA|NORMAL|TIPOCOBERTBIOMETRICA|VISIBLE|UNIQUE|VALID
IXTCB02|NORMAL|TIPOCOBERTBIOMETRICA|VISIBLE|NONUNIQUE|VALID
IXTCB01|NORMAL|TIPOCOBERTBIOMETRICA|VISIBLE|NONUNIQUE|VALID
HISTRESSACUMRISPK|NORMAL|HIST_RESS_ACUMULO_RISCO|VISIBLE|UNIQUE|VALID
HISTSITUACAOCORRETOR|NORMAL|HISTSITUACAOCORRETOR|VISIBLE|UNIQUE|VALID
PKHISTSINISTRO|NORMAL|HISTSINISTRO|VISIBLE|UNIQUE|VALID
PKHISTSEGVIAKITVI|NORMAL|HISTSEGVIAKITVI|VISIBLE|UNIQUE|VALID
FPHISTOBJLANCAMENTOESTORNADO|NORMAL|HISTOBJLANCAMENTOESTORNADO|VISIBLE|UNIQUE|VA
PKHISTLIVRODIARIO|NORMAL|HISTLIVRODIARIO|VISIBLE|UNIQUE|VALID
PKHISTITEMPPRP|NORMAL|HISTITEMPPRP|VISIBLE|UNIQUE|VALID
PKIHISTITEMOUTRISCPESS|NORMAL|HISTITEMOUTRISCPESS|VISIBLE|UNIQUE|VALID
PKHISTITEMINCSIM|NORMAL|HISTITEMINCSIM|VISIBLE|UNIQUE|VALID
PKHISTITEMGENERICO|NORMAL|HISTITEMGENERICO|VISIBLE|UNIQUE|VALID
PKHISTITEMAUTOSIM|NORMAL|HISTITEMAUTOSIM|VISIBLE|UNIQUE|VALID
PKHISTIMPRESSAOEMIS|NORMAL|HISTIMPRESSAOEMIS|VISIBLE|UNIQUE|VALID
IDX$$_6D150001|NORMAL|HISTEMIS|VISIBLE|NONUNIQUE|VALID
PKHISTEMIS|NORMAL|HISTEMIS|VISIBLE|UNIQUE|VALID
PKHISTCONTSEG|NORMAL|HISTCONTSEG|VISIBLE|UNIQUE|VALID
PKHISTCARTASIN|NORMAL|HISTCARTASIN|VISIBLE|UNIQUE|VALID
PKHISTBENEFCOBERTITE|NORMAL|HISTBENEFCOBERTITE|VISIBLE|UNIQUE|VALID
SYS_IL0000028987C00017$$|LOB|HISTAGRUPAMENTO|VISIBLE|UNIQUE|VALID
PKHISTAGRUPAMENTO|NORMAL|HISTAGRUPAMENTO|VISIBLE|UNIQUE|VALID
PKHIERARQUIA|NORMAL|HIERARQUIA|VISIBLE|UNIQUE|VALID
PKGRUPORAMO|NORMAL|GRUPORAMO|VISIBLE|UNIQUE|VALID
PKGRUPOAPROVACAO|NORMAL|GRUPOAPROVACAO|VISIBLE|UNIQUE|VALID
PKGRUPOAPOLICE|NORMAL|GRUPOAPOLICE|VISIBLE|UNIQUE|VALID
IXGIROSIES00|NORMAL|GIRO_X_SIES|VISIBLE|NONUNIQUE|VALID
IXGIROSEG01|NORMAL|GIRO_SEGURADO|VISIBLE|NONUNIQUE|VALID
IXGIRODOC01|NORMAL|GIRO_DOCUMENTO|VISIBLE|NONUNIQUE|VALID
PKGVK|NORMAL|GERVIGKIT|VISIBLE|UNIQUE|VALID
IX_GEPROXSIES_01|NORMAL|GEPRO_X_SIES|VISIBLE|NONUNIQUE|VALID
IDX$$_68CC0001|NORMAL|GEPRO_X_SIES|VISIBLE|NONUNIQUE|VALID
IXGERISPARPEND01|NORMAL|GEPRO_RISCO_PARC_PENDENTE_01|VISIBLE|NONUNIQUE|VALID
IXGERISPAEMI01|NORMAL|GEPRO_RISCO_PARC_EMITIDAS01|VISIBLE|NONUNIQUE|VALID
IXGEPRISPARBX00|FUNCTION-BASED NORMAL|GEPRO_RISCO_PARC_BAIXADAS_01|VISIBLE|NONUN
IXGEPRORISMOVVIDA99_01|NORMAL|GEPRO_RISCO_MOVIMENTO_VIDA_99|VISIBLE|NONUNIQUE|VA
IX_GEPRORISCOMOVVIDA04_01|NORMAL|GEPRO_RISCO_MOVIMENTO_VIDA_04|VISIBLE|NONUNIQUE
IXGEPRORISMOVVIDA04_03|FUNCTION-BASED BITMAP|GEPRO_RISCO_MOVIMENTO_VIDA_04|VISIB
IX_GEPRORISCOMOVVIDA03_01|NORMAL|GEPRO_RISCO_MOVIMENTO_VIDA_03|VISIBLE|NONUNIQUE
IXGEPRORISMOVVIDA03_03|FUNCTION-BASED BITMAP|GEPRO_RISCO_MOVIMENTO_VIDA_03|VISIB
IXGEPRORISMOVVIDA02_04|NORMAL|GEPRO_RISCO_MOVIMENTO_VIDA_02|VISIBLE|NONUNIQUE|VA
IXGEPRORISMOVVIDA02_02|NORMAL|GEPRO_RISCO_MOVIMENTO_VIDA_02|VISIBLE|NONUNIQUE|VA
IX_GEPRORISCOMOVVIDA02_01|NORMAL|GEPRO_RISCO_MOVIMENTO_VIDA_02|VISIBLE|NONUNIQUE
IXGEPRORISMOVVIDA02_03|FUNCTION-BASED BITMAP|GEPRO_RISCO_MOVIMENTO_VIDA_02|VISIB
IXGEPRORISMOVVIDA01_02|NORMAL|GEPRO_RISCO_MOVIMENTO_VIDA_01|VISIBLE|NONUNIQUE|VA
IXGEPRORISMOVVIDA01_04|NORMAL|GEPRO_RISCO_MOVIMENTO_VIDA_01|VISIBLE|NONUNIQUE|VA
IX_GEPRORISCOMOVVIDA01_01|NORMAL|GEPRO_RISCO_MOVIMENTO_VIDA_01|VISIBLE|NONUNIQUE
IXGEPRORISMOVVIDA01_03|FUNCTION-BASED BITMAP|GEPRO_RISCO_MOVIMENTO_VIDA_01|VISIB
IXGEPRORISMOVVIDA00_01|NORMAL|GEPRO_RISCO_MOVIMENTO_VIDA_00|VISIBLE|NONUNIQUE|VA
IXGEPRORISMOVVIDA00_02|NORMAL|GEPRO_RISCO_MOVIMENTO_VIDA_00|VISIBLE|NONUNIQUE|VA
IXGERISCEMI06_00|NORMAL|GEPRO_RISCO_EMISSAO_06|VISIBLE|NONUNIQUE|VALID
IXGERISCEMI06_01|NORMAL|GEPRO_RISCO_EMISSAO_06|VISIBLE|NONUNIQUE|VALID
IXGERISCEM01|FUNCTION-BASED NORMAL|GEPRO_RISCO_EMISSAO_02|VISIBLE|NONUNIQUE|VALI
IXGERISCEM03|NORMAL|GEPRO_RISCO_EMISSAO_02|VISIBLE|NONUNIQUE|VALID
IXGERISCEM02_04|NORMAL|GEPRO_RISCO_EMISSAO_02|VISIBLE|NONUNIQUE|VALID
IXGERISCEM02|NORMAL|GEPRO_RISCO_EMISSAO_02|VISIBLE|NONUNIQUE|VALID
IXGERISEM04|FUNCTION-BASED NORMAL|GEPRO_RISCO_EMISSAO_01|VISIBLE|NONUNIQUE|VALID
IXGERISEM01|NORMAL|GEPRO_RISCO_EMISSAO_01|VISIBLE|NONUNIQUE|VALID
IXGERISEM05|FUNCTION-BASED NORMAL|GEPRO_RISCO_EMISSAO_01|VISIBLE|NONUNIQUE|VALID
IXGERISCEM01_06|NORMAL|GEPRO_RISCO_EMISSAO_01|VISIBLE|NONUNIQUE|VALID
IXGERISEM02|FUNCTION-BASED NORMAL|GEPRO_RISCO_EMISSAO_01|VISIBLE|NONUNIQUE|VALID
IXGEHEADER00|NORMAL|GEPRO_HEADER|VISIBLE|NONUNIQUE|VALID
PKFRANQUIAVARIAVELX|NORMAL|FRANQUIAVARIAVELX|VISIBLE|UNIQUE|VALID
PKFRANQUIAEMISSAOTEXTO|NORMAL|FRANQUIAEMISSAOTEXTO|VISIBLE|UNIQUE|VALID
PKFRANQUIA|NORMAL|FRANQUIA|VISIBLE|UNIQUE|VALID
PKFRACIONAPREMIO|NORMAL|FRACIONAPREMIO|VISIBLE|UNIQUE|VALID
DQFENACOR_DK02|NORMAL|DQ_FENACOR|VISIBLE|NONUNIQUE|VALID
FENACOR_DK00|NORMAL|DQ_FENACOR|VISIBLE|NONUNIQUE|VALID
FENACOR_DK02|NORMAL|DQ_FENACOR|VISIBLE|NONUNIQUE|VALID
PKDPSRESPOSTA|NORMAL|DPS_RESPOSTA|VISIBLE|UNIQUE|VALID
PKDPSPERGUNTASPORPRODUTO|NORMAL|DPS_PERGUNTASPORPRODUTO|VISIBLE|UNIQUE|VALID
PKDPSPERGUNTA|NORMAL|DPS_PERGUNTA|VISIBLE|UNIQUE|VALID
PKDPSCERTRESP|NORMAL|DPS_CERTIFICADO_RESPOSTA|VISIBLE|UNIQUE|VALID
PKDPSCERTOUTSEG|NORMAL|DPS_CERTIFICADO_OUTSEG|VISIBLE|UNIQUE|VALID
PKDOMINIOSIES|NORMAL|DOMINIOSIES|VISIBLE|UNIQUE|VALID
PKDOENCASINISTRO|NORMAL|DOENCASINISTRO|VISIBLE|UNIQUE|VALID
PKDOCUMENTOSINISTRO|NORMAL|DOCUMENTOSINISTRO|VISIBLE|UNIQUE|VALID
PKDOCUMENTOPAGTO|NORMAL|DOCUMENTOPAGTO|VISIBLE|UNIQUE|VALID
PKDOCUMENTOCERTIFICADO|NORMAL|DOCUMENTOCERTIFICADO|VISIBLE|UNIQUE|VALID
PKDOCTOSRO|NORMAL|DOCTOSRO|VISIBLE|UNIQUE|VALID
PKDOCTOSINCOMPLEM|NORMAL|DOCTOSINCOMPLEM|VISIBLE|UNIQUE|VALID
IXDPFI01|NORMAL|DOCTOPAGTOFIN|VISIBLE|NONUNIQUE|VALID
PKDOCTOPAGTOFIN|NORMAL|DOCTOPAGTOFIN|VISIBLE|UNIQUE|VALID
IXDPFI00|NORMAL|DOCTOPAGTOFIN|VISIBLE|NONUNIQUE|VALID
PKDISTRIBCESSAOGRUPO|NORMAL|DISTRIBCESSAOGRUPO|VISIBLE|UNIQUE|VALID
PKDISTRIBCESSAO|NORMAL|DISTRIBCESSAO|VISIBLE|UNIQUE|VALID
PKDISTPARCPREPREV|NORMAL|DISTPARCPREPREV|VISIBLE|UNIQUE|VALID
PKDICTAB|NORMAL|DICTAB|VISIBLE|UNIQUE|VALID
PKDICSIES|NORMAL|DICSIES|VISIBLE|UNIQUE|VALID
PKDEPARACORRMCC|NORMAL|DE_PARA_CORRRETOR_MCC|VISIBLE|UNIQUE|VALID
IXDEPARACONTASMARES01|NORMAL|DE_PARA_CONTAS_MARES|VISIBLE|NONUNIQUE|VALID
IDX$$_87AD0001|FUNCTION-BASED NORMAL|DE_PARA_CONTAS_CONTABEIS|VISIBLE|NONUNIQUE|
IXDPCCONT00|NORMAL|DE_PARA_CONTAS_CONTABEIS|VISIBLE|NONUNIQUE|VALID
PKDEPARACOBCON|NORMAL|DE_PARA_COB_CONNECT|VISIBLE|UNIQUE|VALID
PKDE_PARA_ATIV_CONNECT|NORMAL|DE_PARA_ATIV_CONNECT|VISIBLE|UNIQUE|VALID
PKDETALHEVARIAVELZ|NORMAL|DETALHEVARIAVELZ|VISIBLE|UNIQUE|VALID
PKDETALHEVARIAVELY|NORMAL|DETALHEVARIAVELY|VISIBLE|UNIQUE|VALID
PKDETALHEVARIAVELX|NORMAL|DETALHEVARIAVELX|VISIBLE|UNIQUE|VALID
PKDETALHEFATOROBJ|NORMAL|DETALHEFATOROBJ|VISIBLE|UNIQUE|VALID
PKDESTRELATORIO|NORMAL|DESTRELATORIO|VISIBLE|UNIQUE|VALID
PKDESPESAFIN|NORMAL|DESPESAFIN|VISIBLE|UNIQUE|VALID
PKDESMEMB|NORMAL|DESMEMBTXCIR395UNIFORME|VISIBLE|UNIQUE|VALID
PKDESMEMBTX|NORMAL|DESMEMBTXCIR395FAIXA|VISIBLE|UNIQUE|VALID
PKDESCPROMOCIONAL|NORMAL|DESCPROMOCIONAL|VISIBLE|UNIQUE|VALID
PKDESCPROGRESSIVO|NORMAL|DESCPROGRESSIVO|VISIBLE|UNIQUE|VALID
PKDESCPROGREMISSAO|NORMAL|DESCPROGREMISSAO|VISIBLE|UNIQUE|VALID
PKDESCONTOPINDUPLICADO|NORMAL|DESCONTOPINDUPLICADO|VISIBLE|UNIQUE|VALID
PKDESCONTOIDADE|NORMAL|DESCONTOIDADE|VISIBLE|UNIQUE|VALID
PKDESCONTO|NORMAL|DESCONTO|VISIBLE|UNIQUE|VALID
PKDEPARA_PRODUCAOEMISSAO|NORMAL|DEPARA_PRODUCAOEMISSAO|VISIBLE|UNIQUE|VALID
PKDEPARA_FILIAL_SUCURSAL|NORMAL|DEPARA_FILIAL_SUCURSAL|VISIBLE|UNIQUE|VALID
PKDEPARA_FILIAL|NORMAL|DEPARA_FILIAL|VISIBLE|UNIQUE|VALID
PKDEPARACONTASCC|NORMAL|DEPARA_CONTASCC|VISIBLE|UNIQUE|VALID
PKDEPARA_ASSESSOR|NORMAL|DEPARA_ASSESSOR|VISIBLE|UNIQUE|VALID
PKDEPARAAG|NORMAL|DEPARA_AGENCIAS|VISIBLE|UNIQUE|VALID
IDX$$_04770001|NORMAL|DEPARACOBERTURACIR395|VISIBLE|NONUNIQUE|VALID
PKINFORMACAOATUARIAL|NORMAL|INFORMACAOATUARIAL|VISIBLE|UNIQUE|VALID
PKINFOADICITRANSP|NORMAL|INFOADICITRANSP|VISIBLE|UNIQUE|VALID
PKINFFORMPGTCOMIS|NORMAL|INFFORMPGTCOMIS|VISIBLE|UNIQUE|VALID
PKINFFORMPGTAGENC|NORMAL|INFFORMPGTAGENC|VISIBLE|UNIQUE|VALID
PKINFCONTROLUSR|NORMAL|INFCONTROLUSR|VISIBLE|UNIQUE|VALID
PKINFCONTROLADANA|NORMAL|INFCONTROLADANA|VISIBLE|UNIQUE|VALID
PKINFCONTROLADA|NORMAL|INFCONTROLADA|VISIBLE|UNIQUE|VALID
PKINDICERENOVACAO|NORMAL|INDICERENOVACAO|VISIBLE|UNIQUE|VALID
PKINDICEINADIMPLENCIA|NORMAL|INDICEINADIMPLENCIA|VISIBLE|UNIQUE|VALID
PKINDENIZACAOSINISTRO|NORMAL|INDENIZACAOSINISTRO|VISIBLE|UNIQUE|VALID
IXINCDET00|NORMAL|INCONSISTENCIA_DETALHE|VISIBLE|NONUNIQUE|VALID
PK_INCONSISTENCIA|NORMAL|INCONSISTENCIA|VISIBLE|UNIQUE|VALID
IXINCONSIS00|NORMAL|INCONSISTENCIA|VISIBLE|NONUNIQUE|VALID
IXIIGN01|NORMAL|IMPRESSAOITEMGENERICO|VISIBLE|NONUNIQUE|VALID
PKIMPRESSAOITEMGENERICO|NORMAL|IMPRESSAOITEMGENERICO|VISIBLE|UNIQUE|VALID
PKIMPOSTORENDA|NORMAL|IMPOSTORENDA|VISIBLE|UNIQUE|VALID
PKIMPCRTNRNVVIO|NORMAL|IMPCRTNRNVVI|VISIBLE|UNIQUE|VALID
PKITEMVIAGEMNAC|NORMAL|ITEMVIAGEMNAC|VISIBLE|UNIQUE|VALID
PKITEMVIAGEMINTER|NORMAL|ITEMVIAGEMINTER|VISIBLE|UNIQUE|VALID
PKITEMPREVPRIVADA|NORMAL|ITEMPREVPRIVADA|VISIBLE|UNIQUE|VALID
PKITEMOUTRISCPESSTXT|NORMAL|ITEMOUTRISCPESSTXT|VISIBLE|UNIQUE|VALID
IXIORP09|NORMAL|ITEMOUTRISCPESS|VISIBLE|NONUNIQUE|VALID
IXIORP04|NORMAL|ITEMOUTRISCPESS|VISIBLE|NONUNIQUE|VALID
IXIORP00|NORMAL|ITEMOUTRISCPESS|VISIBLE|NONUNIQUE|VALID
IXIORP10|NORMAL|ITEMOUTRISCPESS|VISIBLE|NONUNIQUE|VALID
FKIORPIORP|NORMAL|ITEMOUTRISCPESS|VISIBLE|NONUNIQUE|VALID
IXIORP12|NORMAL|ITEMOUTRISCPESS|VISIBLE|NONUNIQUE|VALID
PKITEMOUTRISCPESS|NORMAL|ITEMOUTRISCPESS|VISIBLE|UNIQUE|VALID
IXIORP07|NORMAL|ITEMOUTRISCPESS|VISIBLE|NONUNIQUE|VALID
IDX$$_199010001|NORMAL|ITEMOUTRISCPESS|VISIBLE|NONUNIQUE|VALID
IXIORP02|NORMAL|ITEMOUTRISCPESS|VISIBLE|NONUNIQUE|VALID
IXIORP03|NORMAL|ITEMOUTRISCPESS|VISIBLE|NONUNIQUE|VALID
IXIORP05|NORMAL|ITEMOUTRISCPESS|VISIBLE|NONUNIQUE|VALID
IXIORP06|NORMAL|ITEMOUTRISCPESS|VISIBLE|NONUNIQUE|VALID
IXIORP01|NORMAL|ITEMOUTRISCPESS|VISIBLE|NONUNIQUE|VALID
IXIORP13|NORMAL|ITEMOUTRISCPESS|VISIBLE|NONUNIQUE|VALID
IXIORP11|NORMAL|ITEMOUTRISCPESS|VISIBLE|NONUNIQUE|VALID
IXIORP02_ON|NORMAL|ITEMOUTRISCPESS|VISIBLE|NONUNIQUE|VALID
FKPESIORP01|NORMAL|ITEMOUTRISCPESS|VISIBLE|NONUNIQUE|VALID
PKITEMINCSIMILAR|NORMAL|ITEMINCSIMILAR|VISIBLE|UNIQUE|VALID
PKITEMGENERICOTXT|NORMAL|ITEMGENERICOTXT|VISIBLE|UNIQUE|VALID
IXGEN04|NORMAL|ITEMGENERICO|VISIBLE|NONUNIQUE|VALID
IXIGEN01_ON|NORMAL|ITEMGENERICO|VISIBLE|NONUNIQUE|VALID
IXIGEN00_ON|NORMAL|ITEMGENERICO|VISIBLE|NONUNIQUE|VALID
IXIGEN00|NORMAL|ITEMGENERICO|VISIBLE|NONUNIQUE|VALID
IXIGEN07|NORMAL|ITEMGENERICO|VISIBLE|NONUNIQUE|VALID
PKITEMGENERICO|NORMAL|ITEMGENERICO|VISIBLE|UNIQUE|VALID
IDX$$_00010039|NORMAL|ITEMGENERICO|VISIBLE|NONUNIQUE|VALID
IXIGEN05|NORMAL|ITEMGENERICO|VISIBLE|NONUNIQUE|VALID
IXGEN03|NORMAL|ITEMGENERICO|VISIBLE|NONUNIQUE|VALID
IXIGEN02|NORMAL|ITEMGENERICO|VISIBLE|NONUNIQUE|VALID
IXIAS00|NORMAL|ITEMAUTOSIMILAR|VISIBLE|NONUNIQUE|VALID
PKITEMAUTOSIMILAR|NORMAL|ITEMAUTOSIMILAR|VISIBLE|UNIQUE|VALID
PKITEMANIMAL|NORMAL|ITEMANIMAL|VISIBLE|UNIQUE|VALID
PKISRESSEGURO|NORMAL|ISRESSEGURO|VISIBLE|UNIQUE|VALID
IXISP01|NORMAL|ISPREMIO|VISIBLE|NONUNIQUE|VALID
PKISPREMIO|NORMAL|ISPREMIO|VISIBLE|UNIQUE|VALID
IXISP00|NORMAL|ISPREMIO|VISIBLE|NONUNIQUE|VALID
PKISCOEFITABELADO|NORMAL|ISCOEFITABELADO|VISIBLE|UNIQUE|VALID
PK_RELATORIOWOKFLOWVI|NORMAL|RELATORIO_WORKFLOW_VI|VISIBLE|UNIQUE|VALID
PKREGOFICIALCOSSEGCOBRADO|NORMAL|REGOFICIALCOSSEGCOBRADO|VISIBLE|UNIQUE|VALID
PKREGIAOVLMERCADO|NORMAL|REGIAOVLMERCADO|VISIBLE|UNIQUE|VALID
PKREFMONETARIAPREMIO|NORMAL|REFMONETARIAPREMIO|VISIBLE|UNIQUE|VALID
PKREFMONETARIAIS|NORMAL|REFMONETARIAIS|VISIBLE|UNIQUE|VALID
PKREFERMONETARIA|NORMAL|REFERMONETARIA|VISIBLE|UNIQUE|VALID
PKRECUPANTECCOMCOR|NORMAL|RECUPANTECCOMCOR|VISIBLE|UNIQUE|VALID
IXRECUPANTECCOMCOR00|NORMAL|RECUPANTECCOMCOR|VISIBLE|NONUNIQUE|VALID
PKRECUPANTECCOMAGEN|NORMAL|RECUPANTECCOMAGEN|VISIBLE|UNIQUE|VALID
PKRECIBODIVERSOS|NORMAL|RECIBODIVERSOS|VISIBLE|UNIQUE|VALID
PKRECIBODEVOLUCAO|NORMAL|RECIBODEVOLUCAO|VISIBLE|UNIQUE|VALID
PKRECIBOCORRETOR|NORMAL|RECIBOCORRETOR|VISIBLE|UNIQUE|VALID
IXRECCORRETOR|NORMAL|RECIBOCORRETOR|VISIBLE|NONUNIQUE|VALID
REPIQUE_COBRANCA_SIES_PK|NORMAL|REPIQUE_COBRANCA_SIES|VISIBLE|UNIQUE|VALID
REPIQUE_COBRANCA_PK|NORMAL|REPIQUE_COBRANCA|VISIBLE|UNIQUE|VALID
PKREMUNTIPOINSPETOR|NORMAL|REMUNTIPOINSPETOR|VISIBLE|UNIQUE|VALID
PKREMUNERACAOINSPETOR|NORMAL|REMUNERACAOINSPETOR|VISIBLE|UNIQUE|VALID
IXRB06|NORMAL|REMESSABONUS|VISIBLE|NONUNIQUE|VALID
IXRB03|NORMAL|REMESSABONUS|VISIBLE|NONUNIQUE|VALID
IXRB02|NORMAL|REMESSABONUS|VISIBLE|NONUNIQUE|VALID
IXRB01|NORMAL|REMESSABONUS|VISIBLE|NONUNIQUE|VALID
PKREMESSABONUS|NORMAL|REMESSABONUS|VISIBLE|UNIQUE|VALID
IXRB05|NORMAL|REMESSABONUS|VISIBLE|NONUNIQUE|VALID
IXRB04|NORMAL|REMESSABONUS|VISIBLE|NONUNIQUE|VALID
PKRUBRICA|NORMAL|RUBRICA|VISIBLE|UNIQUE|VALID
IXSRR00|NORMAL|SOL_RESULT_RENOVACAO|VISIBLE|NONUNIQUE|VALID
PKSOCIOTOMADOR|NORMAL|SOCIOTOMADOR|VISIBLE|UNIQUE|VALID
PKSOCIOSCORRETOR|NORMAL|SOCIOSCORRETOR|VISIBLE|UNIQUE|VALID
PKSERVIORP|NORMAL|SERVIORP|VISIBLE|UNIQUE|VALID
PKSERVICOSCOMPL|NORMAL|SERVICOSCOMPL|VISIBLE|UNIQUE|VALID
PKSERVCOMPLAGR|NORMAL|SERVCOMPLAGR|VISIBLE|UNIQUE|VALID
PKSEGVIAVGATIVO|NORMAL|SEGVIAVGATIVO|VISIBLE|UNIQUE|VALID
PKSEGURAPARTIC|NORMAL|SEGURAPARTIC|VISIBLE|UNIQUE|VALID
IXCSEG00|NORMAL|SEGURADORA|VISIBLE|UNIQUE|VALID
PKSEGURADORA|NORMAL|SEGURADORA|VISIBLE|UNIQUE|VALID
PKSCHEDULAGEMSISTEMA|NORMAL|SCHEDULAGEMSISTEMA|VISIBLE|UNIQUE|VALID
PKSALVADO|NORMAL|SALVADO|VISIBLE|UNIQUE|VALID
PKRISCOCONTROLA|NORMAL|RISCOCONTROLA|VISIBLE|UNIQUE|VALID
PKPREPOSTOEMISSAO|NORMAL|PREPOSTOEMISSAO|VISIBLE|UNIQUE|VALID
PKPREPOSTOCOMPPRD|NORMAL|PREPOSTOCOMPPRD|VISIBLE|UNIQUE|VALID
PKPREPOSTOCOBERT|NORMAL|PREPOSTOCOBERT|VISIBLE|UNIQUE|VALID
IXPRE00|NORMAL|PREPOSTO|VISIBLE|UNIQUE|VALID
PKPREPOSTO|NORMAL|PREPOSTO|VISIBLE|UNIQUE|VALID
PKPREMIACAOINSRAMO|NORMAL|PREMIACAOINSRAMO|VISIBLE|UNIQUE|VALID
PKPREMIACAOCOLABRAMO|NORMAL|PREMIACAOCOLABRAMO|VISIBLE|UNIQUE|VALID
PKPRDPERPROD|NORMAL|PRDPERPROD|VISIBLE|UNIQUE|VALID
PKPRDORGPRT|NORMAL|PRDORGPRT|VISIBLE|UNIQUE|VALID
PKPRDINSORGPRT|NORMAL|PRDINSORGPRT|VISIBLE|UNIQUE|VALID
PKPRDEMISSTERCEIRO|NORMAL|PRDEMISSTERCEIRO|VISIBLE|UNIQUE|VALID
PKPRDEMISSCOLABORADOR|NORMAL|PRDEMISSCOLABORADOR|VISIBLE|UNIQUE|VALID
PKPRAZOLONGOESPEC|NORMAL|PRAZOLONGOESPEC|VISIBLE|UNIQUE|VALID
PKPRAZOCURTOESPEC|NORMAL|PRAZOCURTOESPEC|VISIBLE|UNIQUE|VALID
IXPROP00|NORMAL|PROPRIETARIONOSSONUMERO|VISIBLE|NONUNIQUE|VALID
PKPROPRIETARIONOSSONUMERO|NORMAL|PROPRIETARIONOSSONUMERO|VISIBLE|UNIQUE|VALID
IXPROP01|NORMAL|PROPRIETARIONOSSONUMERO|VISIBLE|NONUNIQUE|VALID
PKPROPRIETARIA|NORMAL|PROPRIETARIA|VISIBLE|UNIQUE|VALID
PKCDPES|NORMAL|PROMOTOR|VISIBLE|UNIQUE|VALID
PKPROLABORETERCPRODUTO|NORMAL|PROLABORETERCPRODUTO|VISIBLE|UNIQUE|VALID
PKPROLABORETERCEIRORAMO|NORMAL|PROLABORETERCEIRORAMO|VISIBLE|UNIQUE|VALID
PKPROGRAMAS|NORMAL|PROGRAMAS|VISIBLE|UNIQUE|VALID
PRODUCAO_NOVA_EMIT_DIARIA_UK01|NORMAL|PROD_NOVA_EMITIDA_DIARIA_LOCAL|VISIBLE|UNI
TESTE|NORMAL|PRODUTOS_JHY|VISIBLE|UNIQUE|VALID
PKPRODUTOCONTABIL|NORMAL|PRODUTOCONTABIL|VISIBLE|UNIQUE|VALID
STATISTIC_TPITEMSG|NORMAL|PRODUTO|VISIBLE|NONUNIQUE|VALID
IXPROD00|NORMAL|PRODUTO|VISIBLE|NONUNIQUE|VALID
STATISTIC_TPPRODUT|NORMAL|PRODUTO|VISIBLE|NONUNIQUE|VALID
PKPRODUTO|NORMAL|PRODUTO|VISIBLE|UNIQUE|VALID
PRODUCAO_NOVA_UK01|NORMAL|PRODUCAO_NOVA_LOCAL|VISIBLE|UNIQUE|VALID
PRODUCAO_NOVA_EMITIDA_UK01|NORMAL|PRODUCAO_NOVA_EMITIDA_LOCAL|VISIBLE|UNIQUE|VAL
PRODUCAO_NOVA_DIARIA_UK01|NORMAL|PRODUCAO_NOVA_DIARIA_LOCAL|VISIBLE|UNIQUE|VALID
IXPRNVMOV00|NORMAL|PRODUCAONOVAMOVTO|VISIBLE|NONUNIQUE|VALID
IXPRNVMOV01|NORMAL|PRODUCAONOVAMOVTO|VISIBLE|NONUNIQUE|VALID
PK_PRNM|NORMAL|PRODUCAONOVAMOVTO|VISIBLE|UNIQUE|VALID
PK_PRNA|NORMAL|PRODUCAONOVAAPURADA|VISIBLE|UNIQUE|VALID
IXPRNVAPU001|NORMAL|PRODUCAONOVAAPURADA|VISIBLE|NONUNIQUE|VALID
IDX$$_0034000C|NORMAL|PRODUCAONOVAAPURADA|VISIBLE|NONUNIQUE|VALID
IXPRNVAPU00|NORMAL|PRODUCAONOVAAPURADA|VISIBLE|NONUNIQUE|VALID
UK_PRNA01|NORMAL|PRODUCAONOVAAPURADA|VISIBLE|UNIQUE|VALID
PK_PRN|NORMAL|PRODUCAONOVA|VISIBLE|UNIQUE|VALID
IXPRODUCAONOVA01|NORMAL|PRODUCAONOVA|VISIBLE|NONUNIQUE|VALID
IDX$$_2A2440001|NORMAL|PRODUCAONOVA|VISIBLE|NONUNIQUE|VALID
PKPRODUCAOINSPETOR|NORMAL|PRODUCAOINSPETOR|VISIBLE|UNIQUE|VALID
IXPREM01|NORMAL|PRODUCAOEMISSAO|VISIBLE|NONUNIQUE|VALID
PKPRODUCAOEMISSAO|NORMAL|PRODUCAOEMISSAO|VISIBLE|UNIQUE|VALID
PKPRODSIN|NORMAL|PRODSIN|VISIBLE|UNIQUE|VALID
IX_ITFROSIES03|NORMAL|ITF_RO_SIES|VISIBLE|NONUNIQUE|VALID
IX_ITFROSIES02|NORMAL|ITF_RO_SIES|VISIBLE|NONUNIQUE|VALID
IX_ITFROSIES01|NORMAL|ITF_RO_SIES|VISIBLE|NONUNIQUE|VALID
PKIPCR|NORMAL|ITF_PAGTO_CHEQUE_RODAPE|VISIBLE|UNIQUE|VALID
PKIPCD|NORMAL|ITF_PAGTO_CHEQUE_DETALHE|VISIBLE|UNIQUE|VALID
PKIPCC|NORMAL|ITF_PAGTO_CHEQUE_CABECALHO|VISIBLE|UNIQUE|VALID
PKIPR|NORMAL|ITF_PAGAMENTO_RODAPE|VISIBLE|UNIQUE|VALID
PKIPD|NORMAL|ITF_PAGAMENTO_DETALHE|VISIBLE|UNIQUE|VALID
PKIPC|NORMAL|ITF_PAGAMENTO_CABECALHO|VISIBLE|UNIQUE|VALID
PKINSPPARA|NORMAL|ITF_INSPETOR_PARA|VISIBLE|UNIQUE|VALID
PK_INSPDE|NORMAL|ITF_INSPETOR_DE|VISIBLE|UNIQUE|VALID
IXIS00|NORMAL|ITFSUN|VISIBLE|NONUNIQUE|VALID
PKITFSUN|NORMAL|ITFSUN|VISIBLE|UNIQUE|VALID
IXIP01|NORMAL|ITFPESSOA|VISIBLE|NONUNIQUE|VALID
IXIP00|NORMAL|ITFPESSOA|VISIBLE|NONUNIQUE|VALID
PKITFPESSOA|NORMAL|ITFPESSOA|VISIBLE|UNIQUE|VALID
IXIP02|NORMAL|ITFPESSOA|VISIBLE|NONUNIQUE|VALID
IXITFEMISSAO03|NORMAL|ITFEMISSAO|VISIBLE|NONUNIQUE|VALID
IXITFEMISSAO01|NORMAL|ITFEMISSAO|VISIBLE|NONUNIQUE|VALID
IXITFEMISSAO02|NORMAL|ITFEMISSAO|VISIBLE|NONUNIQUE|VALID
PKITFEMISSAO|NORMAL|ITFEMISSAO|VISIBLE|UNIQUE|VALID
PKBENEFITEM|NORMAL|BENEFITEM|VISIBLE|UNIQUE|VALID
PKBENEFCOBERTITEM|NORMAL|BENEFCOBERTITEM|VISIBLE|UNIQUE|VALID
PKBENEFAGRUP|NORMAL|BENEFAGRUP|VISIBLE|UNIQUE|VALID
IXBATGPSAP00|NORMAL|BATIMENTO_GEPRO_SAP|VISIBLE|NONUNIQUE|VALID
IXBATGPSAP03|NORMAL|BATIMENTO_GEPRO_SAP|VISIBLE|NONUNIQUE|VALID
IXBATGPSAP02|NORMAL|BATIMENTO_GEPRO_SAP|VISIBLE|NONUNIQUE|VALID
IXBATGPSAP04|NORMAL|BATIMENTO_GEPRO_SAP|VISIBLE|NONUNIQUE|VALID
IX_BTC_NMPRC|NORMAL|BATCHEXEC|VISIBLE|NONUNIQUE|VALID
IXBATCH00|NORMAL|BATCHEXEC|VISIBLE|NONUNIQUE|VALID
IXBCO00|NORMAL|BANCO|VISIBLE|UNIQUE|VALID
PKBANCO|NORMAL|BANCO|VISIBLE|UNIQUE|VALID
PKBAIXA4507394|NORMAL|BAIXA_4507394|VISIBLE|UNIQUE|VALID
IXBPC05|FUNCTION-BASED NORMAL|BAIXAPARCELABANCO|VISIBLE|NONUNIQUE|VALID
IXBPC02|NORMAL|BAIXAPARCELABANCO|VISIBLE|NONUNIQUE|VALID
IXBPC03|NORMAL|BAIXAPARCELABANCO|VISIBLE|NONUNIQUE|VALID
PKBAIXAPARCELABANCO|NORMAL|BAIXAPARCELABANCO|VISIBLE|UNIQUE|VALID
IXBPC00|NORMAL|BAIXAPARCELABANCO|VISIBLE|NONUNIQUE|VALID
IXBPC01|NORMAL|BAIXAPARCELABANCO|VISIBLE|NONUNIQUE|VALID
IXBPC04|NORMAL|BAIXAPARCELABANCO|VISIBLE|NONUNIQUE|VALID
PKAVISOSINISTROIMAGEM|NORMAL|AVISOSINISTROIMAGEM|VISIBLE|UNIQUE|VALID
SYS_IL0000023459C00008$$|LOB|AVISOSINISTROIMAGEM|VISIBLE|UNIQUE|VALID
IXAVS02|NORMAL|AVISOSINISTRO|VISIBLE|NONUNIQUE|VALID
IXAVS01|NORMAL|AVISOSINISTRO|VISIBLE|NONUNIQUE|VALID
PKAVISOSINISTRO|NORMAL|AVISOSINISTRO|VISIBLE|UNIQUE|VALID
IXAVS00|NORMAL|AVISOSINISTRO|VISIBLE|NONUNIQUE|VALID
SYS_IL0000023458C00049$$|LOB|AVISOSINISTRO|VISIBLE|UNIQUE|VALID
PKAVISOSINCESCOB|NORMAL|AVISOSINCESCOB|VISIBLE|UNIQUE|VALID
PKAVISOSINCES|NORMAL|AVISOSINCES|VISIBLE|UNIQUE|VALID
PKAVARIAS|NORMAL|AVARIAS|VISIBLE|UNIQUE|VALID
PKAUTODEBITO|NORMAL|AUTODEBITO|VISIBLE|UNIQUE|VALID
PKATUARIAL|NORMAL|ATUARIAL|VISIBLE|UNIQUE|VALID
IXATIVPES01|NORMAL|ATIVPESSOA|VISIBLE|NONUNIQUE|VALID
PKATIVPESSOA|NORMAL|ATIVPESSOA|VISIBLE|UNIQUE|VALID
PKASPECTOTECNICO|NORMAL|ASPECTOTECNICO|VISIBLE|UNIQUE|VALID
PKAPROVAINDENIZ|NORMAL|APROVAINDENIZ|VISIBLE|UNIQUE|VALID
PKAPROVAAVISOSINISTRO|NORMAL|APROVAAVISOSINISTRO|VISIBLE|UNIQUE|VALID
PKAPROPJUROS|NORMAL|APROPJUROS|VISIBLE|UNIQUE|VALID
PKAPOLCOSSEGUROACEITO|NORMAL|APOLCOSSEGUROACEITO|VISIBLE|UNIQUE|VALID
IXACA00|NORMAL|APOLCOSSEGUROACEITO|VISIBLE|NONUNIQUE|VALID
PK_AMLOG|NORMAL|APAGAMOVTO_LOG|VISIBLE|UNIQUE|VALID
PKANTECCOMCOR|NORMAL|ANTECCOMCOR|VISIBLE|UNIQUE|VALID
IXANTECCOMCOR00|NORMAL|ANTECCOMCOR|VISIBLE|NONUNIQUE|VALID
PKANTECCOMAGEN|NORMAL|ANTECCOMAGEN|VISIBLE|UNIQUE|VALID
PKAGRUPPRODUTO|NORMAL|AGRUPPRODUTO|VISIBLE|UNIQUE|VALID
PKAGRUPFATCOMERCIAL|NORMAL|AGRUPFATCOMERCIAL|VISIBLE|UNIQUE|VALID
PKAGRUPCOBERTURA|NORMAL|AGRUPCOBERTURA|VISIBLE|UNIQUE|VALID
PKAGRUPAMENTOTXT|NORMAL|AGRUPAMENTOTXT|VISIBLE|UNIQUE|VALID
STATISTIC_CDPES|NORMAL|AGRUPAMENTO|VISIBLE|NONUNIQUE|VALID
STATISTIC_CDAGR|NORMAL|AGRUPAMENTO|VISIBLE|NONUNIQUE|VALID
IXAGR01_ON|NORMAL|AGRUPAMENTO|VISIBLE|NONUNIQUE|VALID
PKAGRUPAMENTO|NORMAL|AGRUPAMENTO|VISIBLE|UNIQUE|VALID
PKAGENCTOTERCEIRORAMO|NORMAL|AGENCTOTERCEIRORAMO|VISIBLE|UNIQUE|VALID
PKAGENCTOTERCEIROPRODUTO|NORMAL|AGENCTOTERCEIROPRODUTO|VISIBLE|UNIQUE|VALID
PKAGENCTOCORRRAMO|NORMAL|AGENCTOCORRRAMO|VISIBLE|UNIQUE|VALID
PKAGENCTOCORRPRODUTO|NORMAL|AGENCTOCORRPRODUTO|VISIBLE|UNIQUE|VALID
PKADICPROGRESSIVO|NORMAL|ADICPROGRESSIVO|VISIBLE|UNIQUE|VALID
PKADICFLUTUANTE|NORMAL|ADICFLUTUANTE|VISIBLE|UNIQUE|VALID
PKACORDO|NORMAL|ACORDO|VISIBLE|UNIQUE|VALID
PKACOMPAPROVAVISOSIN|NORMAL|ACOMPAPROVAVISOSIN|VISIBLE|UNIQUE|VALID
PKDADOSTERCEIRORCF|NORMAL|DADOSTERCEIRORCF|VISIBLE|UNIQUE|VALID
PKCUSTOAPOLICE|NORMAL|CUSTOAPOLICE|VISIBLE|UNIQUE|VALID
PKCTARECFIN|NORMAL|CTARECFIN|VISIBLE|UNIQUE|VALID
PKCRITERCLASRISCO|NORMAL|CRITERCLASRISCO|VISIBLE|UNIQUE|VALID
PKCOTAREFMONETARI|NORMAL|COTAREFMONETARI|VISIBLE|UNIQUE|VALID
PKCORVLMERCREGIAO|NORMAL|CORVLMERCREGIAO|VISIBLE|UNIQUE|VALID
PKCORRETOR_ASSESSOR|NORMAL|CORRETOR_ASSESSOR|VISIBLE|UNIQUE|VALID
PKCORRETORPARTIC|NORMAL|CORRETORPARTIC|VISIBLE|UNIQUE|VALID
PKCORRETORMCS|NORMAL|CORRETORMCS|VISIBLE|UNIQUE|VALID
PKCORRETORFATOR|NORMAL|CORRETORFATOR|VISIBLE|UNIQUE|VALID
IXCORRMP01|NORMAL|CORRETORES_MAPFRE|VISIBLE|NONUNIQUE|VALID
IXCORRMP00|NORMAL|CORRETORES_MAPFRE|VISIBLE|NONUNIQUE|VALID
IDX$$_0117000C|NORMAL|CORRETOR|VISIBLE|NONUNIQUE|VALID
IXCORR00|NORMAL|CORRETOR|VISIBLE|NONUNIQUE|VALID
PKCORRETOR|NORMAL|CORRETOR|VISIBLE|UNIQUE|VALID
IXCORR01|NORMAL|CORRETOR|VISIBLE|NONUNIQUE|VALID
IDX$$_262470008|NORMAL|CORRENTDEVEDOR|VISIBLE|NONUNIQUE|VALID
IXCD00|NORMAL|CORRENTDEVEDOR|VISIBLE|NONUNIQUE|VALID
IXCD02|FUNCTION-BASED NORMAL|CORRENTDEVEDOR|VISIBLE|NONUNIQUE|VALID
IXCD01|NORMAL|CORRENTDEVEDOR|VISIBLE|NONUNIQUE|VALID
PKCORRENTDEVEDOR|NORMAL|CORRENTDEVEDOR|VISIBLE|UNIQUE|VALID
PKCORITFEMISSAO|NORMAL|CORITFEMISSAO|VISIBLE|UNIQUE|VALID
PKCCONVPERIOPREMIO|NORMAL|CONVPERIOPREMIO|VISIBLE|UNIQUE|VALID
PKCONVBBANT|NORMAL|CONVBBANT|VISIBLE|UNIQUE|VALID
PKCONTROLPARGERAL|NORMAL|CONTROLPARGERAL|VISIBLE|UNIQUE|VALID
CS_PK|NORMAL|CONTROLE_SEQUENCIAL_BANCO|VISIBLE|UNIQUE|VALID
PKCONTROLELOTE|NORMAL|CONTROLELOTE|VISIBLE|UNIQUE|VALID
PKCONTROLEIOFVIDA|NORMAL|CONTROLEIOFVIDA|VISIBLE|UNIQUE|VALID
PKCONTROLEIOFPLANOTERC|NORMAL|CONTROLEIOFPLANOTERC|VISIBLE|UNIQUE|VALID
PKCONTROLEIOFPLANOFAIXATERC|NORMAL|CONTROLEIOFPLANOFAIXATERC|VISIBLE|UNIQUE|VALI
PKCONTROLEIOFPLANOFAIXA|NORMAL|CONTROLEIOFPLANOFAIXA|VISIBLE|UNIQUE|VALID
PKCONTROLEIOFPLANO|NORMAL|CONTROLEIOFPLANO|VISIBLE|UNIQUE|VALID
PKCONTROLEIMPRESSAOKIT|NORMAL|CONTROLEIMPRESSAOKIT|VISIBLE|UNIQUE|VALID
IXCIK00|NORMAL|CONTROLEIMPRESSAOKIT|VISIBLE|NONUNIQUE|VALID
PKCONTROLEIMPINFORMEREND|NORMAL|CONTROLEIMPINFORMEREND|VISIBLE|UNIQUE|VALID
PKCONTROLEDEPARA395|NORMAL|CONTROLEDEPARA395|VISIBLE|UNIQUE|VALID
PKCONTRATOSEGURO|NORMAL|CONTRATOSEGURO|VISIBLE|UNIQUE|VALID
IXCSG03|NORMAL|CONTRATOSEGURO|VISIBLE|NONUNIQUE|VALID
IXCSG01|NORMAL|CONTRATOSEGURO|VISIBLE|NONUNIQUE|VALID
IXCSG02|NORMAL|CONTRATOSEGURO|VISIBLE|NONUNIQUE|VALID
IXCSG00|NORMAL|CONTRATOSEGURO|VISIBLE|NONUNIQUE|VALID
IDX$$_3C9080001|NORMAL|CONTRATOSEGURO|VISIBLE|NONUNIQUE|VALID
PKCONTAPESSOA|NORMAL|CONTAPESSOA|VISIBLE|UNIQUE|VALID
PKCONTABANCO|NORMAL|CONTABANCO|VISIBLE|UNIQUE|VALID
PKSCO|NORMAL|CONNECT_SCO|VISIBLE|UNIQUE|VALID
IXCONFILVGDK01|NORMAL|CONJUGEFILHOSVG|VISIBLE|NONUNIQUE|VALID
PKCONJUGEFILHOSVG|NORMAL|CONJUGEFILHOSVG|VISIBLE|UNIQUE|VALID
IXCONFILDK01|NORMAL|CONJUGEFILHOS|VISIBLE|NONUNIQUE|VALID
PKCONJUGEFILHOS|NORMAL|CONJUGEFILHOS|VISIBLE|UNIQUE|VALID
PKCONDUTORVEICULO|NORMAL|CONDUTORVEICULO|VISIBLE|UNIQUE|VALID
PKCONDICGERALRAMO|NORMAL|CONDICGERALRAMO|VISIBLE|UNIQUE|VALID
PKCONDICAOGERPROD|NORMAL|CONDICAOGERPROD|VISIBLE|UNIQUE|VALID
PKCONDGERCOMPPROD|NORMAL|CONDGERCOMPPROD|VISIBLE|UNIQUE|VALID
PKCOMUTACAOPREV|NORMAL|COMUTACAOPREV|VISIBLE|UNIQUE|VALID
PKCOMSELAVERB|NORMAL|COMSELAVERB|VISIBLE|UNIQUE|VALID
PKCOMPSELECPAD|NORMAL|COMPSELECPAD|VISIBLE|UNIQUE|VALID
IXCOMPSELECPAD01|NORMAL|COMPSELECPAD|VISIBLE|NONUNIQUE|VALID
PKCOMPRODEMIS|NORMAL|COMPRODEMIS|VISIBLE|UNIQUE|VALID
IXCPE01|NORMAL|COMPRODEMIS|VISIBLE|NONUNIQUE|VALID
IXCPE02|FUNCTION-BASED NORMAL|COMPRODEMIS|VISIBLE|NONUNIQUE|VALID
PKCOMPRODCOMPOSPROD|NORMAL|COMPRODCOMPOSPROD|VISIBLE|UNIQUE|VALID
PKCOMPRODCOBERT|NORMAL|COMPRODCOBERT|VISIBLE|UNIQUE|VALID
IXCS01|NORMAL|COMPOSSELECIONA|VISIBLE|NONUNIQUE|VALID
PKCOMPOSSELECIONA|NORMAL|COMPOSSELECIONA|VISIBLE|UNIQUE|VALID
IXCS02|NORMAL|COMPOSSELECIONA|INVISIBLE|NONUNIQUE|VALID
PKCOMPOSPRODUTO|NORMAL|COMPOSPRODUTO|VISIBLE|UNIQUE|VALID
PKCOMPOSPRODREFER|NORMAL|COMPOSPRODREFER|VISIBLE|UNIQUE|VALID
PKCOMPOSPLANOATUARIAL|NORMAL|COMPOSPLANOATUARIAL|VISIBLE|UNIQUE|VALID
PKCOMPGRUPO|NORMAL|COMPGRUPO|VISIBLE|UNIQUE|VALID
PKCOMCORRETORRAMO|NORMAL|COMCORRETORRAMO|VISIBLE|UNIQUE|VALID
PKCOMCORRETORPRODUTO|NORMAL|COMCORRETORPRODUTO|VISIBLE|UNIQUE|VALID
PKCOLUNASLOGBKP|NORMAL|COLUNASLOGBKP|VISIBLE|UNIQUE|VALID
PKCOLUNASLOG|NORMAL|COLUNASLOG|VISIBLE|UNIQUE|VALID
IXCOLLOG01|NORMAL|COLUNASLOG|VISIBLE|NONUNIQUE|VALID
IXCOL00|NORMAL|COLABORADOR|VISIBLE|UNIQUE|VALID
PKCOLABORADOR|NORMAL|COLABORADOR|VISIBLE|UNIQUE|VALID
PKCOEFICPRAZLONGO|NORMAL|COEFICPRAZLONGO|VISIBLE|UNIQUE|VALID
PKCOEFICPRAZCURTO|NORMAL|COEFICPRAZCURTO|VISIBLE|UNIQUE|VALID
STATISTIC_CFPRAZOC|NORMAL|COEFICPRAZCURTO|VISIBLE|NONUNIQUE|VALID
PKCOEFICIENTEJUROS|NORMAL|COEFICIENTEJUROS|VISIBLE|UNIQUE|VALID
PKCOEFICIENTEIS|NORMAL|COEFICIENTEIS|VISIBLE|UNIQUE|VALID
PKCOEFAGRAVAMENTO|NORMAL|COEFAGRAVAMENTO|VISIBLE|UNIQUE|VALID
CODIFICACAORAMO_PK|NORMAL|CODIFICACAORAMO|VISIBLE|UNIQUE|VALID
PKCOBRCONJUG|NORMAL|COBRCONJUG|VISIBLE|UNIQUE|VALID
IXCOBSIN00|NORMAL|COBERTURASINISTRO|VISIBLE|NONUNIQUE|VALID
PKCOBERTURASINISTRO|NORMAL|COBERTURASINISTRO|VISIBLE|UNIQUE|VALID
PKCOBERTURAITEM|NORMAL|COBERTURAITEM|VISIBLE|UNIQUE|VALID
IXCIT00|NORMAL|COBERTURAITEM|VISIBLE|NONUNIQUE|VALID
PKCOBERTURAEXCLUSAO|NORMAL|COBERTURAEXCLUSAO|VISIBLE|UNIQUE|VALID
PKCOBERTURACOMERCIAL|NORMAL|COBERTURACOMERCIAL|VISIBLE|UNIQUE|VALID
PKCOBERTURAATUARIALESCOLHIDA|NORMAL|COBERTURAATUARIALESCOLHIDA|VISIBLE|UNIQUE|VA
PKCOBERTURAATUARIAL|NORMAL|COBERTURAATUARIAL|VISIBLE|UNIQUE|VALID
PKCOBERTURA|NORMAL|COBERTURA|VISIBLE|UNIQUE|VALID
IXCOB01|NORMAL|COBERTURA|VISIBLE|NONUNIQUE|VALID
PKCOBERTPLANOINDTERC|NORMAL|COBERTPLANOINDTERC|VISIBLE|UNIQUE|VALID
PKCOBERTPLANOINDIV|NORMAL|COBERTPLANOINDIV|VISIBLE|UNIQUE|VALID
PKCOBERTEXCLUSIVA|NORMAL|COBERTEXCLUSIVA|VISIBLE|UNIQUE|VALID
PKCOBERTACORDO|NORMAL|COBERTACORDO|VISIBLE|UNIQUE|VALID
PKTEXTOSINISTROTXT|NORMAL|TEXTOSINISTROTXT|VISIBLE|UNIQUE|VALID
PKTEXTOSINISTRO|NORMAL|TEXTOSINISTRO|VISIBLE|UNIQUE|VALID
PK_TEXTORECUSADOENCA|NORMAL|TEXTORECUSADOENCA|VISIBLE|UNIQUE|VALID
PKTEXTOPADRAOPROD|NORMAL|TEXTOPADRAOPROD|VISIBLE|UNIQUE|VALID
PKTEXTOCLAUSULATXT|NORMAL|TEXTOCLAUSULATXT|VISIBLE|UNIQUE|VALID
SYS_IL0000029879C00006$$|LOB|TEXTOCLAUSULA|VISIBLE|UNIQUE|VALID
PKTEXTOCLAUSULA|NORMAL|TEXTOCLAUSULA|VISIBLE|UNIQUE|VALID
PKTEXTOCERTIFICADOTXT|NORMAL|TEXTOCERTIFICADOTXT|VISIBLE|UNIQUE|VALID
PKTEXTOCERTIFICADO|NORMAL|TEXTOCERTIFICADO|VISIBLE|UNIQUE|VALID
IXTERC01|NORMAL|TERCEIRO|VISIBLE|NONUNIQUE|VALID
IXTERC00|NORMAL|TERCEIRO|VISIBLE|UNIQUE|VALID
PKTERCEIRO|NORMAL|TERCEIRO|VISIBLE|UNIQUE|VALID
SYS_IL0000461954C00010$$|LOB|WS_COBRANCAREGISTRADA_BB_SITE|VISIBLE|UNIQUE|VALID
SYS_IL0000461954C00011$$|LOB|WS_COBRANCAREGISTRADA_BB_SITE|VISIBLE|UNIQUE|VALID
PKWS_COBRANCAREGISTRADA_BB|NORMAL|WS_COBRANCAREGISTRADA_BB|VISIBLE|UNIQUE|VALID
SYS_IL0000352901C00075$$|LOB|WS_COBRANCAREGISTRADA_BB|VISIBLE|UNIQUE|VALID
SYS_IL0000352901C00076$$|LOB|WS_COBRANCAREGISTRADA_BB|VISIBLE|UNIQUE|VALID
PKVLFIXOCLAUSULA|NORMAL|VLFIXOCLAUSULA|VISIBLE|UNIQUE|VALID
PKVISTORIAPREVIA|NORMAL|VISTORIAPREVIA|VISIBLE|UNIQUE|VALID
PKVISTORIA|NORMAL|VISTORIA|VISIBLE|UNIQUE|VALID
PKVIGREFERMONETIS|NORMAL|VIGREFERMONETIS|VISIBLE|UNIQUE|VALID
PKVIGPREMIOTABELA|NORMAL|VIGPREMIOTABELA|VISIBLE|UNIQUE|VALID
PKVIGPRAZOLONGO|NORMAL|VIGPRAZOLONGO|VISIBLE|UNIQUE|VALID
PKVIGPRAZOCURTO|NORMAL|VIGPRAZOCURTO|VISIBLE|UNIQUE|VALID
PKVIGISCOEFTABELA|NORMAL|VIGISCOEFTABELA|VISIBLE|UNIQUE|VALID
PKVIGFORPGTPREMIO|NORMAL|VIGFORPGTPREMIO|VISIBLE|UNIQUE|VALID
PKVIGCOBERTURAITEM|NORMAL|VIGCOBERTURAITEM|VISIBLE|UNIQUE|VALID
PKVIGCARACTPRODUTO|NORMAL|VIGCARACTPRODUTO|VISIBLE|UNIQUE|VALID
IXTEMPROL43_00|NORMAL|TEMP_ROL43|VISIBLE|NONUNIQUE|VALID
IXTEMPRLVD01|FUNCTION-BASED NORMAL|TEMP_RLVD06|VISIBLE|NONUNIQUE|VALID
IXTMPRESS200|NORMAL|TEMP_RESSEGURO2|VISIBLE|NONUNIQUE|VALID
IXTMPRESS100|NORMAL|TEMP_RESSEGURO1|VISIBLE|NONUNIQUE|VALID
IXTMPRESS00|NORMAL|TEMP_RESSEGURO|VISIBLE|NONUNIQUE|VALID
TEMP_PTARQ111|NORMAL|TEMP_PTARQ111|VISIBLE|UNIQUE|VALID
IXTMPPRESS14|NORMAL|TEMP_PRESS14|VISIBLE|NONUNIQUE|VALID
PKTEMPPMCV17|NORMAL|TEMP_PMCV17|VISIBLE|UNIQUE|VALID
IXTMPMCV01|NORMAL|TEMP_PMCV04|VISIBLE|NONUNIQUE|VALID
PKTEMP_PLA01|NORMAL|TEMP_PLA01|VISIBLE|UNIQUE|VALID
IXPINTRC01|NORMAL|TEMP_PIN_TROCADO|VISIBLE|NONUNIQUE|VALID
IXPINTRC02|NORMAL|TEMP_PIN_TROCADO|VISIBLE|NONUNIQUE|VALID
IXPINTRC00|NORMAL|TEMP_PIN_TROCADO|VISIBLE|NONUNIQUE|VALID
IXTMPPEPARQUIVODETALHE02|NORMAL|TEMP_PEPARQUIVODETALHE|VISIBLE|NONUNIQUE|VALID
IXTMPPEPARQUIVODETALHE03|NORMAL|TEMP_PEPARQUIVODETALHE|VISIBLE|NONUNIQUE|VALID
IXTMPPEPARQUIVODETALHE04|BITMAP|TEMP_PEPARQUIVODETALHE|VISIBLE|NONUNIQUE|VALID
IXTMPPEPARQUIVODETALHE01|NORMAL|TEMP_PEPARQUIVODETALHE|VISIBLE|NONUNIQUE|VALID
IXTEMPPEM3200|NORMAL|TEMP_PEM32|VISIBLE|NONUNIQUE|VALID
IXTEMPPEMFL00|NORMAL|TEMP_PEM301_03_SEGMENTACAO|VISIBLE|NONUNIQUE|VALID
PK_TEMP_DE_PARA_PLANO_VG_395|NORMAL|TEMP_DE_PARA_PLANO_VG_395|VISIBLE|UNIQUE|VAL
PKTEMP_DADOS_CARTA_RECUSA_VI|NORMAL|TEMP_DADOS_CARTA_RECUSA_VI|VISIBLE|UNIQUE|VA
IDX_TEMPCPFCNPJDETA_01|NORMAL|TEMP_CPF_CNPJ_DETA|VISIBLE|NONUNIQUE|VALID
IDX_FK_CPF_CPFDETA|NORMAL|TEMP_CPF_CNPJ_DETA|VISIBLE|NONUNIQUE|VALID
PK_TEMP_CPF_CNPJ|NORMAL|TEMP_CPF_CNPJ|VISIBLE|UNIQUE|VALID
IXTEMPCPFCNPJ00|BITMAP|TEMP_CPF_CNPJ|VISIBLE|NONUNIQUE|VALID
PK_TEMPCIRC429DETA|NORMAL|TEMP_CIRCULAR_429_DETALHE|VISIBLE|UNIQUE|VALID
IX_TEMPCIRC429CAB_01|NORMAL|TEMP_CIRCULAR_429_CABECALHO|VISIBLE|NONUNIQUE|VALID
PK_TEMPCIRC429CAB|NORMAL|TEMP_CIRCULAR_429_CABECALHO|VISIBLE|UNIQUE|VALID
IXCARGACORRETOR02|NORMAL|TEMP_CARGA_CORRETOR|VISIBLE|NONUNIQUE|VALID
IXCARGA_CORRETOR01|NORMAL|TEMP_CARGA_CORRETOR|VISIBLE|NONUNIQUE|VALID
PKTEMP_AUDITORIA|NORMAL|TEMP_AUDITORIA|VISIBLE|UNIQUE|VALID
IXTEMPAJUSTBX01|NORMAL|TEMP_AJUSTEBMK_BAIXA|VISIBLE|NONUNIQUE|VALID
IXTEMPAJUST01|NORMAL|TEMP_AJUSTEBMK|VISIBLE|NONUNIQUE|VALID
IXTMPACRIS00|NORMAL|TEMP_ACUMULO_RISCO_RESS|VISIBLE|NONUNIQUE|VALID
IXTMPACRIS01|NORMAL|TEMP_ACUMULO_RISCO_RESS|VISIBLE|NONUNIQUE|VALID
IXTMPACRIS02|NORMAL|TEMP_ACUMULO_RISCO_RESS|VISIBLE|NONUNIQUE|VALID
IXTMPACRIS03|NORMAL|TEMP_ACUMULO_RISCO_RESS|VISIBLE|NONUNIQUE|VALID
PK_303_TAXAS|NORMAL|TEMP_303_TAXAS|VISIBLE|UNIQUE|VALID
PK_TEMP_303_DE_PARA|NORMAL|TEMP_303_DE_PARA|VISIBLE|UNIQUE|VALID
IXTEMPVMOURA2|NORMAL|TEMPVMOURA2|VISIBLE|NONUNIQUE|VALID
PKTEMP01PMPPR21|NORMAL|TEMP01_PMPPR21|VISIBLE|NONUNIQUE|VALID
PKTELEFONEPESSOA|NORMAL|TELEFONEPESSOA|VISIBLE|UNIQUE|VALID
PKRETENCAODIFCOBGRUPO|NORMAL|RETENCAODIFCOBGRUPO|VISIBLE|UNIQUE|VALID
PKRESUMOVIDA|NORMAL|RESUMOVIDA|VISIBLE|UNIQUE|VALID
IXRV01|NORMAL|RESUMOVIDA|VISIBLE|NONUNIQUE|VALID
IXRV00|NORMAL|RESUMOVIDA|VISIBLE|NONUNIQUE|VALID
RESSTABUATAXAPK|NORMAL|RESSTABUATAXA|VISIBLE|UNIQUE|VALID
RESSTABUAPLANOPK|NORMAL|RESSTABUAPLANO|VISIBLE|UNIQUE|VALID
IXRESSPRDTXCON00|NORMAL|RESSPRODTAXACONSEG|VISIBLE|NONUNIQUE|VALID
RESSPRODTAXACONSEG|NORMAL|RESSPRODTAXACONSEG|VISIBLE|UNIQUE|VALID
IXRESSPRDTXAGR01|NORMAL|RESSPRODTAXAAGR|VISIBLE|NONUNIQUE|VALID
RESSPRODTAXAAGRPK|NORMAL|RESSPRODTAXAAGR|VISIBLE|UNIQUE|VALID
IXRESSPRDTXAGR|NORMAL|RESSPRODTAXAAGR|VISIBLE|NONUNIQUE|VALID
RESPRODTAXAPK|NORMAL|RESSPRODTAXA|VISIBLE|UNIQUE|VALID
RESSPRODLIMRETPK|NORMAL|RESSPRODLIMRET|VISIBLE|UNIQUE|VALID
IXRESSMOV04|NORMAL|RESSMOVIMENTO|VISIBLE|NONUNIQUE|VALID
IXRESSMOV00|NORMAL|RESSMOVIMENTO|VISIBLE|NONUNIQUE|VALID
PKRESSMOV|NORMAL|RESSMOVIMENTO|VISIBLE|UNIQUE|VALID
IXRESSMOV02|NORMAL|RESSMOVIMENTO|VISIBLE|NONUNIQUE|VALID
IXRESSMOV01|NORMAL|RESSMOVIMENTO|VISIBLE|NONUNIQUE|VALID
IXRESSMOV03|NORMAL|RESSMOVIMENTO|VISIBLE|NONUNIQUE|VALID
PKRESSEGVIDAMOVTOCALCULOREC|NORMAL|RESSEGVIDAMOVTOCALCULOREC|VISIBLE|UNIQUE|VALI
PKRESSEGVIDAMOVTOCALCULO|NORMAL|RESSEGVIDAMOVTOCALCULO|VISIBLE|UNIQUE|VALID
PKRESSEGVIDAEMISCOBERT|NORMAL|RESSEGVIDAEMISCOBERT|VISIBLE|UNIQUE|VALID
RESSACURISCOPK|NORMAL|RESSEGURO_ACUMULO_RISCO|VISIBLE|UNIQUE|VALID
RESSTABUAPK|NORMAL|RESSEGUROTABUA|VISIBLE|UNIQUE|VALID
PKRESSEGPRDPL|NORMAL|RESSEGUROPRODUTOPLANO|VISIBLE|UNIQUE|VALID
RESSPRODPK|NORMAL|RESSEGUROPRODUTO|VISIBLE|UNIQUE|VALID
IXRESSEMI02|NORMAL|RESSEGUROEMISSAO|VISIBLE|NONUNIQUE|VALID
IXREESSEMI00|NORMAL|RESSEGUROEMISSAO|VISIBLE|NONUNIQUE|VALID
IXRESSEMI01|NORMAL|RESSEGUROEMISSAO|VISIBLE|NONUNIQUE|VALID
PKRESSEMI|NORMAL|RESSEGUROEMISSAO|VISIBLE|UNIQUE|VALID
RESSCERTIFPK|NORMAL|RESSEGUROCERTIF|VISIBLE|UNIQUE|VALID
RESSCERTIFTAXA|NORMAL|RESSCERTIFTAXA|VISIBLE|UNIQUE|VALID
RESSCERTIFLIMRETPK|NORMAL|RESSCERTIFLIMRET|VISIBLE|UNIQUE|VALID
PKRESSARCIMENTO|NORMAL|RESSARCIMENTO|VISIBLE|UNIQUE|VALID
PKRESSACUMULORISCO|NORMAL|RESSACUMULORISCO|VISIBLE|UNIQUE|VALID
IXRESSACRIS01|NORMAL|RESSACUMULORISCO|VISIBLE|NONUNIQUE|VALID
IXRESSACRIS00|NORMAL|RESSACUMULORISCO|VISIBLE|NONUNIQUE|VALID
PKRESPOSTARCP|NORMAL|RESPOSTARCP|VISIBLE|UNIQUE|VALID
PKRESERVASINISTRO|NORMAL|RESERVASINISTRO|VISIBLE|UNIQUE|VALID
PKRESERVAPREV|NORMAL|RESERVAPREV|VISIBLE|UNIQUE|VALID
IXRER02|FUNCTION-BASED NORMAL|RESERVAEMISSAORAMO|VISIBLE|NONUNIQUE|VALID
IXRER01|NORMAL|RESERVAEMISSAORAMO|VISIBLE|NONUNIQUE|VALID
PKRESERVAEMISSAORAMO|NORMAL|RESERVAEMISSAORAMO|VISIBLE|UNIQUE|VALID
IXRER00|NORMAL|RESERVAEMISSAORAMO|VISIBLE|NONUNIQUE|VALID
IXPES02|NORMAL|PESSOA|VISIBLE|NONUNIQUE|VALID
IXPES05|FUNCTION-BASED BITMAP|PESSOA|VISIBLE|NONUNIQUE|VALID
IXPES03|NORMAL|PESSOA|VISIBLE|NONUNIQUE|VALID
IXPES08|FUNCTION-BASED NORMAL|PESSOA|VISIBLE|NONUNIQUE|VALID
IXPES09|NORMAL|PESSOA|VISIBLE|NONUNIQUE|VALID
IXPES07|NORMAL|PESSOA|VISIBLE|NONUNIQUE|VALID
IXPES04|NORMAL|PESSOA|VISIBLE|NONUNIQUE|VALID
PKPESSOA|NORMAL|PESSOA|VISIBLE|UNIQUE|VALID
IXPES01|NORMAL|PESSOA|VISIBLE|NONUNIQUE|VALID
PKPERIODOPRODUCAO|NORMAL|PERIODOPRODUCAO|VISIBLE|UNIQUE|VALID
FKPERIODOFUNDOFIXO|NORMAL|PERIODOFUNDOFIXO|VISIBLE|UNIQUE|VALID
PKPARCELAPLANOPAGTO|NORMAL|PERCENTUALPLANOPAGTO|VISIBLE|UNIQUE|VALID
PKPEPRESULTADOCARGA|NORMAL|PEPRESULTADOCARGA|VISIBLE|UNIQUE|VALID
PKPEPRELACIONADO|NORMAL|PEPRELACIONADO|VISIBLE|UNIQUE|VALID
DKPEPORGAOS|NORMAL|PEPORGAOS|VISIBLE|NONUNIQUE|VALID
PKPEPORGAOS|NORMAL|PEPORGAOS|VISIBLE|UNIQUE|VALID
IXPEPHIST01|NORMAL|PEPHIST|VISIBLE|NONUNIQUE|VALID
PKPEPHIST|NORMAL|PEPHIST|VISIBLE|UNIQUE|VALID
PKPEPDETALHE|NORMAL|PEPDETALHECARGA|VISIBLE|UNIQUE|VALID
IXPEPCARGO00|NORMAL|PEPCARGO|VISIBLE|NONUNIQUE|VALID
PKPEPCARGO|NORMAL|PEPCARGO|VISIBLE|UNIQUE|VALID
PKPEP|NORMAL|PEP|VISIBLE|UNIQUE|VALID
IXPEP01|NORMAL|PEP|VISIBLE|NONUNIQUE|VALID
IXPEP02|NORMAL|PEP|VISIBLE|NONUNIQUE|VALID
IXPEP03|NORMAL|PEP|VISIBLE|NONUNIQUE|VALID
PKPEM25_ARQUIVO3|NORMAL|PEM25_ARQUIVO3|VISIBLE|UNIQUE|VALID
PKPEM25_ARQUIVO2|NORMAL|PEM25_ARQUIVO2|VISIBLE|UNIQUE|VALID
PKPEM25_ARQUIVO1|NORMAL|PEM25_ARQUIVO1|VISIBLE|UNIQUE|VALID
PKPARMIGCON|NORMAL|PARAM_MIGRACAO_CONNECT|VISIBLE|UNIQUE|VALID
PKPARAMFATTRANS|NORMAL|PARAMFATTRANS|VISIBLE|UNIQUE|VALID
PKPARAMFATAGRUP|NORMAL|PARAMFATAGRUP|VISIBLE|UNIQUE|VALID
PKPARAMETROSISTEMA|NORMAL|PARAMETRO_SISTEMA|VISIBLE|UNIQUE|VALID
PKPARAMETROOBJETO|NORMAL|PARAMETROOBJETO|VISIBLE|UNIQUE|VALID
PKPARAMETROLIMITESFIN|NORMAL|PARAMETROLIMITESFIN|VISIBLE|UNIQUE|VALID
PKPARAMETROGERAL|NORMAL|PARAMETROGERAL|VISIBLE|UNIQUE|VALID
IXPRF02|NORMAL|PARAMETROFATURA|VISIBLE|NONUNIQUE|VALID
IXPRF01_ON|NORMAL|PARAMETROFATURA|VISIBLE|NONUNIQUE|VALID
PKPARAMETROFATURA|NORMAL|PARAMETROFATURA|VISIBLE|UNIQUE|VALID
PKPARAMETRODIRETORIO|NORMAL|PARAMETRODIRETORIO|VISIBLE|UNIQUE|VALID
PKPARAMDOCPESSOA|NORMAL|PARAMDOCPESSOA|VISIBLE|UNIQUE|VALID
PARAMCONTARELATORIO|NORMAL|PARAMCONTARELATORIO|VISIBLE|UNIQUE|VALID
PKPARAMALCADA|NORMAL|PARAMALCADA|VISIBLE|UNIQUE|VALID
PKPAPELTERCEIRO|NORMAL|PAPELTERCEIRO|VISIBLE|UNIQUE|VALID
PKPAIS|NORMAL|PAIS|VISIBLE|UNIQUE|VALID
PKPAGTOPREV|NORMAL|PAGTOPREV|VISIBLE|UNIQUE|VALID
IXPAGANTCON02|NORMAL|PAGTOANTECIP_CONNECT|VISIBLE|NONUNIQUE|VALID
IXPAGANTCON01|NORMAL|PAGTOANTECIP_CONNECT|VISIBLE|NONUNIQUE|VALID
IXPGANT02|NORMAL|PAGTOANTECIPADO|VISIBLE|NONUNIQUE|VALID
PKPAGTOANTECIPADO|NORMAL|PAGTOANTECIPADO|VISIBLE|UNIQUE|VALID
IXPGANT01|NORMAL|PAGTOANTECIPADO|VISIBLE|NONUNIQUE|VALID
PKORIGDESTVIAGEM|NORMAL|ORIGDESTVIAGEM|VISIBLE|UNIQUE|VALID
PKORGAOPRODUTOR|NORMAL|ORGAOPRODUTOR|VISIBLE|UNIQUE|VALID
IDX$$_262470002|NORMAL|OPTANTEDEBCTA|VISIBLE|NONUNIQUE|VALID
PKOPERACAOPADRAO|NORMAL|OPERACAOPADRAO|VISIBLE|UNIQUE|VALID
PKCDOPERACAO|NORMAL|OPERACAOBANCO|VISIBLE|UNIQUE|VALID
PKOPERACAO|NORMAL|OPERACAO|VISIBLE|UNIQUE|VALID
PKOCORINTBANCO|NORMAL|OCORINTBANCO|VISIBLE|UNIQUE|VALID
PKOCORCOSSEGAC|NORMAL|OCORCOSSEGAC|VISIBLE|UNIQUE|VALID
PKOBJRISCOCONTROL|NORMAL|OBJRISCOCONTROL|VISIBLE|UNIQUE|VALID
PKOBJRISCOCOMPPRD|NORMAL|OBJRISCOCOMPPRD|VISIBLE|UNIQUE|VALID
PKOBJPLANOCESSAO|NORMAL|OBJPLANOCESSAO|VISIBLE|UNIQUE|VALID
PKOBJETOVERBA|NORMAL|OBJETOVERBA|VISIBLE|UNIQUE|VALID
PKOBJETORISCO|NORMAL|OBJETORISCO|VISIBLE|UNIQUE|VALID
PKOBJETOPRODUTO|NORMAL|OBJETOPRODUTO|VISIBLE|UNIQUE|VALID
IXOL04|NORMAL|OBJETOLANCAMENTO|VISIBLE|NONUNIQUE|VALID
IDX$$_0122000A|NORMAL|OBJETOLANCAMENTO|VISIBLE|NONUNIQUE|VALID
IXOL00|NORMAL|OBJETOLANCAMENTO|VISIBLE|NONUNIQUE|VALID
IXOL02|NORMAL|OBJETOLANCAMENTO|VISIBLE|NONUNIQUE|VALID
IXOL02_BA|NORMAL|OBJETOLANCAMENTO|VISIBLE|NONUNIQUE|VALID
IXOL01|NORMAL|OBJETOLANCAMENTO|VISIBLE|NONUNIQUE|VALID
FPOBJETOLANCAMENTO|NORMAL|OBJETOLANCAMENTO|VISIBLE|UNIQUE|VALID
IXOL05|NORMAL|OBJETOLANCAMENTO|VISIBLE|NONUNIQUE|VALID
IXOL03|NORMAL|OBJETOLANCAMENTO|VISIBLE|NONUNIQUE|VALID
PKOBJCOMPOSICAO|NORMAL|OBJCOMPOSICAO|VISIBLE|UNIQUE|VALID
PKNUMEROORDEMCOSSEGURO|NORMAL|NUMEROORDEMCOSSEGURO|VISIBLE|UNIQUE|VALID
PKNUMERADORDOC|NORMAL|NUMERADORDOC|VISIBLE|UNIQUE|VALID
PKNUMERADORAPOLICE|NORMAL|NUMERADORAPOLICE|VISIBLE|UNIQUE|VALID
PKNOTAFISCAL|NORMAL|NOTAFISCAL|VISIBLE|UNIQUE|VALID
PKNIVELCOMISVP|NORMAL|NIVELCOMISVP|VISIBLE|UNIQUE|VALID
PKNIVELALCADAUN|NORMAL|NIVELALCADAUN|VISIBLE|UNIQUE|VALID
PKNIVELALCADA|NORMAL|NIVELALCADA|VISIBLE|UNIQUE|VALID
PKNAVIO|NORMAL|NAVIO|VISIBLE|UNIQUE|VALID
PKNATUREZAITEM|NORMAL|NATUREZAITEM|VISIBLE|UNIQUE|VALID
PKMOVTOTERPREVPRIV|NORMAL|MOVTOTERPREVPRIV|VISIBLE|UNIQUE|VALID
IXMVSI07|NORMAL|MOVTOSINISTRO|VISIBLE|NONUNIQUE|VALID
FKOLMS|NORMAL|MOVTOSINISTRO|VISIBLE|NONUNIQUE|VALID
PKMOVTOSINISTRO|NORMAL|MOVTOSINISTRO|VISIBLE|UNIQUE|VALID
IXMVSI00|NORMAL|MOVTOSINISTRO|VISIBLE|NONUNIQUE|VALID
IXMVSI06|FUNCTION-BASED NORMAL|MOVTOSINISTRO|VISIBLE|NONUNIQUE|VALID
IXMVSI05|FUNCTION-BASED NORMAL|MOVTOSINISTRO|VISIBLE|NONUNIQUE|VALID
IXMVSI04|FUNCTION-BASED NORMAL|MOVTOSINISTRO|VISIBLE|NONUNIQUE|VALID
IXMVSI03|FUNCTION-BASED NORMAL|MOVTOSINISTRO|VISIBLE|NONUNIQUE|VALID
IXMVSI01|NORMAL|MOVTOSINISTRO|VISIBLE|NONUNIQUE|VALID
IXMVSI02|NORMAL|MOVTOSINISTRO|VISIBLE|NONUNIQUE|VALID
PKMOVTOPARCRESSEGURORAMO|NORMAL|MOVTOPARCRESSEGURORAMO|VISIBLE|UNIQUE|VALID
IXMPCR00|NORMAL|MOVTOPARCPREMIORAMO|VISIBLE|NONUNIQUE|VALID
IXMPCRM05|NORMAL|MOVTOPARCPREMIORAMO|VISIBLE|NONUNIQUE|VALID
IXMPCRM04|NORMAL|MOVTOPARCPREMIORAMO|VISIBLE|NONUNIQUE|VALID
IXMPCRM03|NORMAL|MOVTOPARCPREMIORAMO|VISIBLE|NONUNIQUE|VALID
IXMPCRM06|NORMAL|MOVTOPARCPREMIORAMO|VISIBLE|NONUNIQUE|VALID
PKMOVTOPARCPREMIORAMO|NORMAL|MOVTOPARCPREMIORAMO|VISIBLE|UNIQUE|VALID
IXMPCRM02|NORMAL|MOVTOPARCPREMIORAMO|VISIBLE|NONUNIQUE|VALID
IXMPCRM08|NORMAL|MOVTOPARCPREMIORAMO|VISIBLE|NONUNIQUE|VALID
IXMPCRM01|NORMAL|MOVTOPARCPREMIORAMO|VISIBLE|NONUNIQUE|VALID
IXMPCRM07|NORMAL|MOVTOPARCPREMIORAMO|VISIBLE|NONUNIQUE|VALID
PKMOVTOPARCPREMIACAORAMO|NORMAL|MOVTOPARCPREMIACAORAMO|VISIBLE|UNIQUE|VALID
IXMOVTOPACPAGTOTERCITEMDEL01|NORMAL|MOVTOPARCPAGTOTERCITEMDEL|VISIBLE|NONUNIQUE|
PKMOVTOPARCPAGTOTERCITEMDEL|NORMAL|MOVTOPARCPAGTOTERCITEMDEL|VISIBLE|UNIQUE|VALI
IXMOVTOPARCPAGTOTERCITEMDEL02|NORMAL|MOVTOPARCPAGTOTERCITEMDEL|VISIBLE|NONUNIQUE
IXMOVTOPARCPAGTOTERCITEMDEL00|NORMAL|MOVTOPARCPAGTOTERCITEMDEL|VISIBLE|NONUNIQUE
IXMOVTOPACPAGTOTERCITEM01|NORMAL|MOVTOPARCPAGTOTERCITEM|VISIBLE|NONUNIQUE|VALID
PKMOVTOPARCPAGTOTERCITEM|NORMAL|MOVTOPARCPAGTOTERCITEM|VISIBLE|UNIQUE|VALID
IXMOVTOPARCPAGTOTERCITEM00|NORMAL|MOVTOPARCPAGTOTERCITEM|VISIBLE|NONUNIQUE|VALID
IXMOVTOPARCPAGTOTERCITEM03|NORMAL|MOVTOPARCPAGTOTERCITEM|VISIBLE|NONUNIQUE|VALID
IXMOVTOPARCPAGTOTERCITEM02|NORMAL|MOVTOPARCPAGTOTERCITEM|VISIBLE|NONUNIQUE|VALID
PKMOVTOPARCELAPREMIO|NORMAL|MOVTOPARCELAPREMIO|VISIBLE|UNIQUE|VALID
IXMOVTOPARC02|NORMAL|MOVTOPARCELAPREMIO|VISIBLE|NONUNIQUE|VALID
IXMOVTOPARC01|NORMAL|MOVTOPARCELAPREMIO|VISIBLE|NONUNIQUE|VALID
IDX$$_01B60007|NORMAL|MOVTOPARCELAPAGTOTERCEIRO|VISIBLE|NONUNIQUE|VALID
PKMOVTOPARCELAPAGTOTERCEIRO|NORMAL|MOVTOPARCELAPAGTOTERCEIRO|VISIBLE|UNIQUE|VALI
IXMOVTOPARCELAPAGTOTERCEIRO00|NORMAL|MOVTOPARCELAPAGTOTERCEIRO|VISIBLE|NONUNIQUE
IXMOVTOPARCELAPAGTOTERCEIRO01|NORMAL|MOVTOPARCELAPAGTOTERCEIRO|VISIBLE|NONUNIQUE
IXMOVTOPARCELAPAGTOTERCEIRO02|NORMAL|MOVTOPARCELAPAGTOTERCEIRO|VISIBLE|NONUNIQUE
IXMPCR01|NORMAL|MOVTOPARCELACESSAORAMO|VISIBLE|NONUNIQUE|VALID
IDX$$_01B60006|NORMAL|MOVTOPARCELACESSAORAMO|VISIBLE|NONUNIQUE|VALID
PKMOVTOPARCELACESSAORAMO|NORMAL|MOVTOPARCELACESSAORAMO|VISIBLE|UNIQUE|VALID
IXMOVTOPARCELACESSAORAMO00|NORMAL|MOVTOPARCELACESSAORAMO|VISIBLE|NONUNIQUE|VALID
IXMPCR02|NORMAL|MOVTOPARCELACESSAORAMO|VISIBLE|NONUNIQUE|VALID
PKMOVTOPARCCOMISSRAMO|NORMAL|MOVTOPARCCOMISSRAMO|VISIBLE|UNIQUE|VALID
IXMOVTOPARCCOMISSRAMO04|NORMAL|MOVTOPARCCOMISSRAMO|VISIBLE|NONUNIQUE|VALID
IXMOVTOPARCCOMISSRAMO08|NORMAL|MOVTOPARCCOMISSRAMO|VISIBLE|NONUNIQUE|VALID
IXMOVTOPARCCOMISSRAMO05|NORMAL|MOVTOPARCCOMISSRAMO|VISIBLE|NONUNIQUE|VALID
IXMOVTOPARCCOMISSRAMO06|NORMAL|MOVTOPARCCOMISSRAMO|VISIBLE|NONUNIQUE|VALID
IXMOVTOPARCCOMISSRAMO03|NORMAL|MOVTOPARCCOMISSRAMO|VISIBLE|NONUNIQUE|VALID
IXMOVTOPARCCOMISSRAMO01|NORMAL|MOVTOPARCCOMISSRAMO|VISIBLE|NONUNIQUE|VALID
IXMOVTOPARCCOMISSRAMO00|NORMAL|MOVTOPARCCOMISSRAMO|VISIBLE|NONUNIQUE|VALID
PKMOVTOPAGTOTESOURARIA|NORMAL|MOVTOPAGTOTESOURARIA|VISIBLE|UNIQUE|VALID
MOVTOMANUALPROMOTOR|NORMAL|MOVTOMANUALPROMOTOR|VISIBLE|NONUNIQUE|VALID
PKMOVTOMANUALPROMOTOR|NORMAL|MOVTOMANUALPROMOTOR|VISIBLE|UNIQUE|VALID
MOVTOMANUALAGENC|NORMAL|MOVTOMANUALAGENC|VISIBLE|NONUNIQUE|VALID
IXMOVMANAG02|NORMAL|MOVTOMANUALAGENC|VISIBLE|NONUNIQUE|VALID
PKMOVTOMANUALAGENC|NORMAL|MOVTOMANUALAGENC|VISIBLE|UNIQUE|VALID
IXMOVTOMANUAL01|NORMAL|MOVTOMANUAL|VISIBLE|NONUNIQUE|VALID
IXMOVTOMANUAL02|NORMAL|MOVTOMANUAL|VISIBLE|NONUNIQUE|VALID
PKMOVTOMANUAL|NORMAL|MOVTOMANUAL|VISIBLE|UNIQUE|VALID
FKMOVTOFUNDOFIXO|NORMAL|MOVTOFUNDOFIXO|VISIBLE|UNIQUE|VALID
PKMOVSERVIORP|NORMAL|MOVSERVIORP|VISIBLE|UNIQUE|VALID
PKMOVRISCOCONTROL|NORMAL|MOVRISCOCONTROL|VISIBLE|UNIQUE|VALID
PKMOVPREMEMITIDOS|NORMAL|MOVPREMEMITIDOS|VISIBLE|UNIQUE|VALID
IXMOVSERV01|NORMAL|MOVIMENTO_SERVICO|VISIBLE|NONUNIQUE|VALID
IDX$$_262470006|NORMAL|MOVIMENTO_SERVICO|VISIBLE|NONUNIQUE|VALID
IXMOVSERV02|NORMAL|MOVIMENTO_SERVICO|VISIBLE|NONUNIQUE|VALID
PKMOVIMENTOSERVICO|NORMAL|MOVIMENTO_SERVICO|VISIBLE|UNIQUE|VALID
IDX$$_262470003|NORMAL|MOVIMENTO_SERVICO|VISIBLE|NONUNIQUE|VALID
IDX$$_262470001|NORMAL|MOVIMENTO_SERVICO|VISIBLE|NONUNIQUE|VALID
IXMDOCPG01|NORMAL|MOVDOCTOFIN|VISIBLE|NONUNIQUE|VALID
PKMOVDOCTOFIN|NORMAL|MOVDOCTOFIN|VISIBLE|UNIQUE|VALID
IXMDOCPG03|NORMAL|MOVDOCTOFIN|VISIBLE|NONUNIQUE|VALID
IXMDOCPG02|NORMAL|MOVDOCTOFIN|VISIBLE|NONUNIQUE|VALID
IXMCV06|NORMAL|MOVCOBERTURAVIDA|VISIBLE|NONUNIQUE|VALID
IXMCV08|NORMAL|MOVCOBERTURAVIDA|VISIBLE|NONUNIQUE|VALID
PKMOVCOBERTURAVIDA|NORMAL|MOVCOBERTURAVIDA|VISIBLE|UNIQUE|VALID
IXMCV01|NORMAL|MOVCOBERTURAVIDA|VISIBLE|NONUNIQUE|VALID
IXMCV07|NORMAL|MOVCOBERTURAVIDA|VISIBLE|NONUNIQUE|VALID
IXMCV02|NORMAL|MOVCOBERTURAVIDA|VISIBLE|NONUNIQUE|VALID
IXMCV13|NORMAL|MOVCOBERTURAVIDA|VISIBLE|NONUNIQUE|VALID
IXMCV04|NORMAL|MOVCOBERTURAVIDA|VISIBLE|NONUNIQUE|VALID
IXMCV11|NORMAL|MOVCOBERTURAVIDA|VISIBLE|NONUNIQUE|VALID
IXMCV12|NORMAL|MOVCOBERTURAVIDA|VISIBLE|NONUNIQUE|VALID
IXMCV09|NORMAL|MOVCOBERTURAVIDA|VISIBLE|NONUNIQUE|VALID
IXMCV10|NORMAL|MOVCOBERTURAVIDA|VISIBLE|NONUNIQUE|VALID
PKMOVCOBERTURAPREV|NORMAL|MOVCOBERTURAPREV|VISIBLE|UNIQUE|VALID
PKMOVCOBERTURAPP|NORMAL|MOVCOBERTURAPP|VISIBLE|UNIQUE|VALID
PKMOVCOBERTURA|NORMAL|MOVCOBERTURA|VISIBLE|UNIQUE|VALID
PKMOTIVO|NORMAL|MOTIVOSINISTRO|VISIBLE|UNIQUE|VALID
PKMOTIVORETORNOBANCO|NORMAL|MOTIVORETORNOBANCO|VISIBLE|UNIQUE|VALID
PKMOTIVORETOCORBANCO|NORMAL|MOTIVORETOCORBANCO|VISIBLE|UNIQUE|VALID
PKMOTIVORECUSAEMISSAO|NORMAL|MOTIVORECUSAEMISSAO|VISIBLE|UNIQUE|VALID
PKMODULO|NORMAL|MODULO|VISIBLE|UNIQUE|VALID
PKMODNIVALCADA|NORMAL|MODNIVALCADA|VISIBLE|UNIQUE|VALID
PKMODELOTXTPADRAOTXT|NORMAL|MODELOTXTPADRAOTXT|VISIBLE|UNIQUE|VALID
SYS_IL0000029117C00006$$|LOB|MODELOTXTPADRAO|VISIBLE|UNIQUE|VALID
PKMODELOTXTPADRAO|NORMAL|MODELOTXTPADRAO|VISIBLE|UNIQUE|VALID
PKINTERFACEPP|NORMAL|INTERFACEPP|VISIBLE|UNIQUE|VALID
PKINTERFACEEMISSAO|NORMAL|INTERFACEEMISSAO|VISIBLE|UNIQUE|VALID
PKINSTRFICHACOMPENSACAO|NORMAL|INSTRFICHACOMPENSACAO|VISIBLE|UNIQUE|VALID
UK01INSTITUIDORA|NORMAL|INSTITUIDORA|VISIBLE|UNIQUE|VALID
PKINSTITUIDORA|NORMAL|INSTITUIDORA|VISIBLE|UNIQUE|VALID
PKINSS|NORMAL|INSS|VISIBLE|UNIQUE|VALID
PKINSPETOR|NORMAL|INSPETOR|VISIBLE|UNIQUE|VALID
IXINS00|NORMAL|INSPETOR|VISIBLE|UNIQUE|VALID
PKFORMAPGTORESSEGURO|NORMAL|FORMAPGTORESSEGURO|VISIBLE|UNIQUE|VALID
PKFORMAPGTOPREMIO|NORMAL|FORMAPGTOPREMIO|VISIBLE|UNIQUE|VALID
PKFORMAPAGTOCESSAO|NORMAL|FORMAPGTOCESSAO|VISIBLE|UNIQUE|VALID
PKFORMAPAGTOTROCADA|NORMAL|FORMAPAGTOTROCADA|VISIBLE|UNIQUE|VALID
PKFORMAPAGAMENTO|NORMAL|FORMAPAGAMENTO|VISIBLE|UNIQUE|VALID
PKFOLLOWUPRESSEGURO|NORMAL|FOLLOWUPRESSEGURO|VISIBLE|UNIQUE|VALID
PKFOLLOWUPCOSSEGURO|NORMAL|FOLLOWUPCOSSEGURO|VISIBLE|UNIQUE|VALID
IXFWUP02|NORMAL|FOLLOWUP|VISIBLE|NONUNIQUE|VALID
IXFWUP00|NORMAL|FOLLOWUP|VISIBLE|NONUNIQUE|VALID
FKFOLLOWUP|NORMAL|FOLLOWUP|VISIBLE|UNIQUE|VALID
IXFWUP01|NORMAL|FOLLOWUP|VISIBLE|NONUNIQUE|VALID
PKFILTROCLAUSULAAUTO|NORMAL|FILTROCLAUSULAAUTO|VISIBLE|UNIQUE|VALID
FKPESFF|NORMAL|FICHAFINANCEIRA|VISIBLE|NONUNIQUE|VALID
PKFICHAFINANCEIRA|NORMAL|FICHAFINANCEIRA|VISIBLE|UNIQUE|VALID
PKFICHAATUARIAL|NORMAL|FICHAATUARIAL|VISIBLE|UNIQUE|VALID
PKFERIADOS|NORMAL|FERIADOS|VISIBLE|UNIQUE|VALID
PKFCANAOBAIXADO|NORMAL|FCANAOBAIXADO|VISIBLE|UNIQUE|VALID
IXFAT02|NORMAL|FATURA|VISIBLE|NONUNIQUE|VALID
IXFAT07|NORMAL|FATURA|VISIBLE|NONUNIQUE|VALID
IXFAT05|NORMAL|FATURA|VISIBLE|NONUNIQUE|VALID
IXFAT01|NORMAL|FATURA|VISIBLE|NONUNIQUE|VALID
IXFAT03|NORMAL|FATURA|VISIBLE|NONUNIQUE|VALID
IXFAT04|FUNCTION-BASED NORMAL|FATURA|VISIBLE|NONUNIQUE|VALID
PKFATURA|NORMAL|FATURA|VISIBLE|UNIQUE|VALID
IXFAT06|FUNCTION-BASED NORMAL|FATURA|VISIBLE|NONUNIQUE|VALID
PKFATORPREMIOTAB|NORMAL|FATORPREMIOTAB|VISIBLE|UNIQUE|VALID
PKFATOROBJETO|NORMAL|FATOROBJETO|VISIBLE|UNIQUE|VALID
PKFATOREMISSAOITEM|NORMAL|FATOREMISSAOITEM|VISIBLE|UNIQUE|VALID
PKEXCBAIXASAP|NORMAL|EXCBAIXASAP|VISIBLE|UNIQUE|VALID
PKEVENTOPREV|NORMAL|EVENTOPREV|VISIBLE|UNIQUE|VALID
PKEVENTOENDSPRODEXCL|NORMAL|EVENTOENDSPRODEXCL|VISIBLE|UNIQUE|VALID
PKEVENTOENDOSSOPROD|NORMAL|EVENTOENDOSSOPROD|VISIBLE|UNIQUE|VALID
PKEVENTOENDOSSOEMIS|NORMAL|EVENTOENDOSSOEMIS|VISIBLE|UNIQUE|VALID
PKEVENTOENDOSSO|NORMAL|EVENTOENDOSSO|VISIBLE|UNIQUE|VALID
PKEVENTOALCADA|NORMAL|EVENTOALCADA|VISIBLE|UNIQUE|VALID
PKESTUDORCP|NORMAL|ESTUDORCP|VISIBLE|UNIQUE|VALID
PKESTUDOCOTACAO|NORMAL|ESTUDOCOTACAO|VISIBLE|UNIQUE|VALID
PKESTUDOATUARIALESCALONADO|NORMAL|ESTUDOATUARIALESCALONADO|VISIBLE|UNIQUE|VALID
PKESTUDOATUARIAL|NORMAL|ESTUDOATUARIAL|VISIBLE|UNIQUE|VALID
IXESTCOM00|NORMAL|ESTRUTURA_COMPLETA|VISIBLE|NONUNIQUE|VALID
PKESTADOEMISSAO|NORMAL|ESTADOEMISSAO|VISIBLE|UNIQUE|VALID
PKEQUIPAMENTO|NORMAL|EQUIPAMENTO|VISIBLE|UNIQUE|VALID
PKENQUADRAMENTOMOVCOBERTURA|NORMAL|ENQUADRAMENTOMOVCOBERTURA|VISIBLE|UNIQUE|VALI
PKENQUADRAMENTOITEM|NORMAL|ENQUADRAMENTOITEM|VISIBLE|UNIQUE|VALID
PKENQUADRAMENTO|NORMAL|ENQUADRAMENTO|VISIBLE|UNIQUE|VALID
PKENQUADCERTEMIS|NORMAL|ENQUADCERTEMIS|VISIBLE|UNIQUE|VALID
PKENDERECOPESSOAVG|NORMAL|ENDERECOPESSOAVG|VISIBLE|UNIQUE|VALID
IDX$$_BFEF0001|NORMAL|ENDERECOPESSOA|VISIBLE|NONUNIQUE|VALID
PKENDERECOPESSOA|NORMAL|ENDERECOPESSOA|VISIBLE|UNIQUE|VALID
PKEMPRESTIMOCORRETOR|NORMAL|EMPRESTIMOCORRETOR|VISIBLE|UNIQUE|VALID
IXEMPC00|NORMAL|EMPRESACOLABORADOR|VISIBLE|UNIQUE|VALID
PKEMPRESACOLABORADOR|NORMAL|EMPRESACOLABORADOR|VISIBLE|UNIQUE|VALID
PKEMISSAOESTUDO|NORMAL|EMISSAOESTUDO|VISIBLE|UNIQUE|VALID
IXEM05|NORMAL|EMISSAO|VISIBLE|NONUNIQUE|VALID
IXEM06|NORMAL|EMISSAO|VISIBLE|NONUNIQUE|VALID
IXEM03|NORMAL|EMISSAO|VISIBLE|NONUNIQUE|VALID
IXEM14|NORMAL|EMISSAO|VISIBLE|NONUNIQUE|VALID
IXEM04|NORMAL|EMISSAO|VISIBLE|NONUNIQUE|VALID
IDX$$_003D0001|NORMAL|EMISSAO|VISIBLE|NONUNIQUE|VALID
PKEMISSAO|NORMAL|EMISSAO|VISIBLE|UNIQUE|VALID
IXEM11|NORMAL|EMISSAO|VISIBLE|NONUNIQUE|VALID
IXEM01|NORMAL|EMISSAO|VISIBLE|NONUNIQUE|VALID
IXEM00|NORMAL|EMISSAO|VISIBLE|NONUNIQUE|VALID
IXEM13|NORMAL|EMISSAO|INVISIBLE|NONUNIQUE|VALID
STATISTIC_TPORGPRTSUC|NORMAL|EMISSAO|VISIBLE|NONUNIQUE|VALID
IXEM16|NORMAL|EMISSAO|VISIBLE|NONUNIQUE|VALID
IXEM07|NORMAL|EMISSAO|VISIBLE|NONUNIQUE|VALID
IXEM02|NORMAL|EMISSAO|VISIBLE|NONUNIQUE|VALID
IXEM10|NORMAL|EMISSAO|VISIBLE|NONUNIQUE|VALID
IXEM09|NORMAL|EMISSAO|VISIBLE|NONUNIQUE|VALID
IXEM08|NORMAL|EMISSAO|VISIBLE|NONUNIQUE|VALID
IXEM15|NORMAL|EMISSAO|VISIBLE|NONUNIQUE|VALID
IXEM12|NORMAL|EMISSAO|VISIBLE|NONUNIQUE|VALID
IDX$$_01AC000B|FUNCTION-BASED NORMAL|EMISSAO|VISIBLE|NONUNIQUE|VALID
PKEMISSAGRUP|NORMAL|EMISSAGRUP|VISIBLE|UNIQUE|VALID
PKEMBALAGEM|NORMAL|EMBALAGEM|VISIBLE|UNIQUE|VALID
PKEMAIL_RECUSA|NORMAL|EMAIL_RECUSA|VISIBLE|UNIQUE|VALID
PKEMAILSPROCESSO|NORMAL|EMAILSPROCESSO|VISIBLE|UNIQUE|VALID
PKEDUCTIPOMEMCALC|NORMAL|EDUCTIPOMEMCALC|VISIBLE|UNIQUE|VALID
PKEDUCSERIESACURFUNDAMENTAL|NORMAL|EDUCSERIESACURFUNDAMENTAL|VISIBLE|UNIQUE|VALI
PKEDUCRESUMOMEMCALC|NORMAL|EDUCRESUMOMEMCALC|VISIBLE|UNIQUE|VALID
PKEDUCPARAMMEMCALC|NORMAL|EDUCPARAMMEMCALC|VISIBLE|UNIQUE|VALID
PKEDUCMEMORIACALCULO|NORMAL|EDUCMEMORIACALCULO|VISIBLE|UNIQUE|VALID
PKEDUCDISCACURSUPERIOR|NORMAL|EDUCDISCACURSUPERIOR|VISIBLE|UNIQUE|VALID
PKEDUCCOBERTURASADICIONAIS|NORMAL|EDUCCOBERTURASADICIONAIS|VISIBLE|UNIQUE|VALID
PKEDUCANOLETIVSUPERIOR|NORMAL|EDUCANOLETIVSUPERIOR|VISIBLE|UNIQUE|VALID
PKEDUCANOLETIVFUNDAMENTAL|NORMAL|EDUCANOLETIVFUNDAMENTAL|VISIBLE|UNIQUE|VALID
CODCICLO|NORMAL|EDUCACIONALCICLOS|VISIBLE|UNIQUE|VALID
IXECTB02|NORMAL|EC_TRANSF_BATCH|VISIBLE|NONUNIQUE|VALID
IXECTB01|NORMAL|EC_TRANSF_BATCH|VISIBLE|NONUNIQUE|VALID
PK_EC_NOSNUM|NORMAL|EC_NOSNUM|VISIBLE|UNIQUE|VALID

Executed in 33,344 seconds
