select t.INDEX_NAME || '|' ||
       t.INDEX_TYPE || '|' ||
	   t.TABLE_NAME || '|' ||
	   t.VISIBILITY || '|' ||
       t.UNIQUENESS || '|' ||
	   t.STATUS
from DBA_INDEXES t
where t.OWNER = '&schema';
&schema: RCGERALADM
IXTERCEIRO01|DOMAIN|TERCEIRO|VISIBLE|NONUNIQUE|VALID
PKVALORESRISCOCOTACAO|NORMAL|VALORESRISCOCOTACAO|VISIBLE|UNIQUE|VALID
PKTIPORISCOCOTACAO|NORMAL|TIPORISCOCOTACAO|VISIBLE|UNIQUE|VALID
PKTIPORESSEGUROCOTACAO|NORMAL|TIPORESSEGUROCOTACAO|VISIBLE|UNIQUE|VALID
PKTIPOFRANQUIACOTACAO|NORMAL|TIPOFRANQUIACOTACAO|VISIBLE|UNIQUE|VALID
PKTIPDOMICILIO|NORMAL|TIPODOMICILIO|VISIBLE|UNIQUE|VALID
CKDCDOMICILIO|NORMAL|TIPODOMICILIO|VISIBLE|UNIQUE|VALID
PKTIPODADOPLANILHA|NORMAL|TIPODADOPLANILHA|VISIBLE|UNIQUE|VALID
PKTIPOCALCULOCOTACAO|NORMAL|TIPOCALCULOCOTACAO|VISIBLE|UNIQUE|VALID
PKTERCEIROCOTACAO|NORMAL|TERCEIROCOTACAO|VISIBLE|UNIQUE|VALID
PKTERCEIRO|NORMAL|TERCEIRO|VISIBLE|UNIQUE|VALID
PKSUBSCRICAOCOTACAO|NORMAL|SUBSCRICAOCOTACAO|VISIBLE|UNIQUE|VALID
PKSTATUSCOTACAO|NORMAL|STATUSCOTACAO|VISIBLE|UNIQUE|VALID
PKROTEIROCALCULOCOTACAO|NORMAL|ROTEIROCALCULOCOTACAO|VISIBLE|UNIQUE|VALID
PKRESPOSTACOTACAO|NORMAL|RESPOSTACOTACAO|VISIBLE|UNIQUE|VALID
PKQUESTIONARIOCOBERTURA|NORMAL|QUESTIONARIOCOBERTURA|VISIBLE|UNIQUE|VALID
CKCOBERTURA_VERSAO|NORMAL|QUESTIONARIOCOBERTURA|VISIBLE|UNIQUE|VALID
PKPARAMETROSISTEMA|NORMAL|PARAMETROSISTEMA|VISIBLE|UNIQUE|VALID
PKMOTIVOSUBSCRICAO|NORMAL|MOTIVOSUBSCRICAO|VISIBLE|UNIQUE|VALID
PKMODALIDADECOTACAO|NORMAL|MODALIDADECOTACAO|VISIBLE|UNIQUE|VALID
PKLINHAPLANILHA|NORMAL|LINHAPLANILHA|VISIBLE|UNIQUE|VALID
PKFORMAPAGTOCOTACAO|NORMAL|FORMAPAGTOCOTACAO|VISIBLE|UNIQUE|VALID
PKDESCRICAOPLANILHA|NORMAL|DESCRICAOPLANILHA|VISIBLE|UNIQUE|VALID
CKDCPLANILHA|NORMAL|DESCRICAOPLANILHA|VISIBLE|UNIQUE|VALID
PKDEPENDENCIACOBERTURA|NORMAL|DEPENDENCIACOBERTURA|VISIBLE|UNIQUE|VALID
PKBASICOCOTACAO|NORMAL|COTACAO|VISIBLE|UNIQUE|VALID
PKCONGENERECOTACAO|NORMAL|CONGENERECOTACAO|VISIBLE|UNIQUE|VALID
PKCOLUNAPLANILHA|NORMAL|COLUNAPLANILHA|VISIBLE|UNIQUE|VALID
PKCOBERTURA|NORMAL|COBERTURA|VISIBLE|UNIQUE|VALID
PKCLAUSULACOTACAO|NORMAL|CLAUSULACOTACAO|VISIBLE|UNIQUE|VALID
PKCALCULOCOTACAO|NORMAL|CALCULOCOTACAO|VISIBLE|UNIQUE|VALID
PKCADASTROQUESTIONARIO|NORMAL|CADASTROQUESTIONARIO|VISIBLE|UNIQUE|VALID
PKBASECOTACAO|NORMAL|BASECOTACAO|VISIBLE|UNIQUE|VALID
PKATIVIDADECOTACAO|NORMAL|ATIVIDADECOTACAO|VISIBLE|UNIQUE|VALID
PKARQUIVOCOTACAO|NORMAL|ARQUIVOCOTACAO|VISIBLE|UNIQUE|VALID
PKADMCOBERTURA|NORMAL|ADMCOBERTURA|VISIBLE|UNIQUE|VALID
DR$IXTERCEIRO01$X|NORMAL|DR$IXTERCEIRO01$I|VISIBLE|NONUNIQUE|VALID
SYS_IOT_TOP_58192|IOT - TOP|DR$IXTERCEIRO01$N|VISIBLE|UNIQUE|VALID
SYS_IL0000058189C00002$$|LOB|DR$IXTERCEIRO01$R|VISIBLE|UNIQUE|VALID
SYS_IOT_TOP_58187|IOT - TOP|DR$IXTERCEIRO01$K|VISIBLE|UNIQUE|VALID
SYS_IL0000058184C00006$$|LOB|DR$IXTERCEIRO01$I|VISIBLE|UNIQUE|VALID
IX_FKCLASSE_COBERTURA01|NORMAL|CLASSE_COBERTURA|VISIBLE|NONUNIQUE|VALID
PKDEMONSTRATIVO_FRANQUIA|NORMAL|DEMONSTRATIVO_FRANQUIA|VISIBLE|UNIQUE|VALID
IXCOLUNAPLANILHA01|NORMAL|COLUNAPLANILHA|VISIBLE|NONUNIQUE|VALID
SYS_IL0000055515C00007$$|LOB|ARQUIVOCOTACAO|VISIBLE|UNIQUE|VALID

Executed in 0,844 seconds
spool off
